"","date","nonmembers","alumni","community_members","students","faculty_staff","pe_staff","other","total"
"1",2015-01-05,7,34,22,6796,2,79,0,6940
"2",2015-01-06,10,29,35,6181,2,447,0,6704
"3",2015-01-07,15,34,45,5843,68,204,0,6209
"4",2015-01-08,9,25,46,5097,1,19,0,5197
"5",2015-01-09,13,30,45,4219,0,117,0,4424
"6",2015-01-10,8,19,30,2715,0,3,0,2775
"7",2015-01-11,8,19,40,2843,0,6,0,2916
"8",2015-01-12,5,27,23,2980,0,22,0,3057
"9",2015-01-13,8,28,42,4988,6,41,0,5113
"10",2015-01-14,9,39,44,5606,0,25,1,5724
"11",2015-01-15,14,28,45,5046,0,18,1,5152
"12",2015-01-16,13,34,61,3496,1,12,0,3617
"13",2015-01-17,6,19,29,2441,0,1,0,2496
"14",2015-01-18,3,22,26,2174,1,1,0,2227
"15",2015-01-19,10,26,32,2526,0,1,0,2595
"16",2015-01-20,14,44,63,5376,1,19,2,5519
"17",2015-01-21,9,46,55,5322,0,18,2,5452
"18",2015-01-22,7,33,54,5278,0,16,2,5390
"19",2015-01-23,12,28,47,4062,0,9,2,4160
"20",2015-01-24,2,26,36,2551,0,1,0,2616
"21",2015-01-25,6,14,35,2216,0,3,0,2274
"22",2015-01-26,14,44,58,5153,0,16,4,5289
"23",2015-01-27,6,45,70,4831,0,14,2,4968
"24",2015-01-28,11,39,67,5005,0,14,5,5141
"25",2015-01-29,12,33,57,4782,0,9,2,4895
"26",2015-01-30,11,37,55,3441,0,7,1,3552
"27",2015-01-31,8,22,39,2348,0,1,0,2418
"28",2015-02-01,5,21,26,1670,0,3,0,1725
"29",2015-02-02,15,42,68,5172,0,17,4,5318
"30",2015-02-03,10,40,54,4974,0,21,3,5102
"31",2015-02-04,8,30,60,4963,0,14,2,5077
"32",2015-02-05,11,27,65,4672,0,16,2,4793
"33",2015-02-06,9,44,50,3476,0,11,2,3592
"34",2015-02-07,5,20,45,2484,0,2,0,2556
"35",2015-02-08,13,30,39,2078,0,1,0,2161
"36",2015-02-09,9,50,63,4916,0,9,1,5048
"37",2015-02-10,8,40,62,5086,0,6,3,5205
"38",2015-02-11,6,46,65,5066,1,16,4,5204
"39",2015-02-12,12,37,65,4615,0,7,3,4739
"40",2015-02-13,12,33,44,3158,0,36,0,3283
"41",2015-02-14,3,28,29,1716,0,5,0,1781
"42",2015-02-15,5,23,29,1810,0,1,0,1868
"43",2015-02-16,9,41,72,5059,0,16,3,5200
"44",2015-02-17,1,44,61,4745,0,11,2,4864
"45",2015-02-18,6,38,67,4575,1,273,4,4964
"46",2015-02-19,6,32,62,4296,0,12,2,4410
"47",2015-02-20,11,33,57,3060,0,4,1,3166
"48",2015-02-21,3,27,43,1952,0,1,0,2026
"49",2015-02-22,4,22,32,2081,0,0,0,2139
"50",2015-02-23,12,37,70,4881,0,8,1,5009
"51",2015-02-24,5,42,70,4807,0,9,3,4936
"52",2015-02-25,5,46,74,4335,0,7,2,4469
"53",2015-02-26,4,42,71,4306,0,9,1,4433
"54",2015-02-27,7,26,51,3092,1,5,1,3183
"55",2015-02-28,4,23,39,2161,0,1,0,2228
"56",2015-03-01,4,23,37,2063,0,0,0,2127
"57",2015-03-02,16,48,58,4764,0,69,2,4957
"58",2015-03-03,6,38,66,4335,0,7,2,4454
"59",2015-03-04,5,41,63,4373,0,6,2,4490
"60",2015-03-05,4,32,67,4218,0,3,4,4328
"61",2015-03-06,6,35,39,2954,0,7,2,3043
"62",2015-03-07,6,16,36,2047,0,0,0,2105
"63",2015-03-08,4,21,40,1986,0,0,0,2051
"64",2015-03-09,8,30,64,4741,0,8,4,4855
"65",2015-03-10,8,39,62,4463,0,4,3,4579
"66",2015-03-11,8,38,55,4382,0,7,4,4494
"67",2015-03-12,6,27,43,3976,0,28,1,4081
"68",2015-03-13,8,33,47,3060,0,1,3,3152
"69",2015-03-14,1,16,34,2243,0,3,0,2297
"70",2015-03-15,3,32,40,2313,0,3,0,2391
"71",2015-03-16,12,31,57,2827,0,3,3,2933
"72",2015-03-17,7,34,44,2527,0,7,0,2619
"73",2015-03-18,11,30,35,2095,0,6,0,2177
"74",2015-03-19,5,22,21,1196,0,7,0,1251
"75",2015-03-20,5,25,27,858,0,2,1,918
"76",2015-03-21,0,0,0,0,0,0,0,0
"77",2015-03-22,0,0,0,0,0,0,0,0
"78",2015-03-23,8,22,31,723,0,7,2,793
"79",2015-03-24,6,26,22,696,0,2,0,752
"80",2015-03-25,5,24,14,636,0,6,0,685
"81",2015-03-26,1,17,17,573,0,4,0,612
"82",2015-03-27,10,22,17,590,0,5,0,644
"83",2015-03-28,0,0,0,0,0,1,0,1
"84",2015-03-29,0,11,10,876,0,1,0,898
"85",2015-03-30,11,31,54,5512,0,16,0,5624
"86",2015-03-31,14,32,54,5654,0,17,1,5772
"87",2015-04-01,11,38,55,5399,0,5,0,5508
"88",2015-04-02,9,32,50,4959,0,5,1,5056
"89",2015-04-03,13,30,52,3043,0,2,1,3141
"90",2015-04-04,5,16,33,2017,0,1,0,2072
"91",2015-04-05,2,26,37,2060,0,3,0,2128
"92",2015-04-06,7,38,86,5525,0,16,1,5673
"93",2015-04-07,15,42,70,5701,0,16,1,5845
"94",2015-04-08,3,37,74,5712,0,10,0,5836
"95",2015-04-09,10,29,70,5087,0,5,3,5204
"96",2015-04-10,11,31,44,3379,0,3,2,3470
"97",2015-04-11,5,18,36,2242,0,1,0,2302
"98",2015-04-12,3,22,32,2099,0,0,0,2156
"99",2015-04-13,7,36,71,5138,0,11,1,5264
"100",2015-04-14,25,42,65,5493,0,10,2,5637
"101",2015-04-15,6,30,74,5075,0,13,0,5198
"102",2015-04-16,11,25,48,4640,0,11,3,4738
"103",2015-04-17,11,26,42,2941,0,6,2,3028
"104",2015-04-18,2,11,20,1888,0,2,0,1923
"105",2015-04-19,6,14,31,1902,0,2,0,1955
"106",2015-04-20,7,40,56,4439,0,13,1,4556
"107",2015-04-21,21,30,71,4899,0,9,3,5033
"108",2015-04-22,10,41,73,4638,1,10,0,4773
"109",2015-04-23,15,31,63,4495,0,7,6,4617
"110",2015-04-24,14,30,37,3174,0,6,3,3264
"111",2015-04-25,6,17,47,2306,0,3,0,2379
"112",2015-04-26,3,22,38,2097,0,1,0,2161
"113",2015-04-27,5,46,69,4771,0,7,1,4899
"114",2015-04-28,20,34,63,4859,0,12,3,4991
"115",2015-04-29,8,35,63,4696,0,11,0,4813
"116",2015-04-30,7,38,64,4307,0,7,3,4426
"117",2015-05-01,13,31,44,2731,0,2,1,2822
"118",2015-05-02,4,13,22,1344,0,0,0,1383
"119",2015-05-03,2,16,38,2064,0,0,0,2120
"120",2015-05-04,7,45,65,4653,0,8,1,4779
"121",2015-05-05,11,31,62,4589,0,5,4,4702
"122",2015-05-06,9,36,65,4303,0,6,0,4419
"123",2015-05-07,9,33,60,4392,0,7,4,4505
"124",2015-05-08,12,23,44,2664,0,4,3,2750
"125",2015-05-09,3,11,25,1657,0,2,0,1698
"126",2015-05-10,6,14,34,1894,0,4,0,1952
"127",2015-05-11,10,42,70,4297,0,11,2,4432
"128",2015-05-12,13,29,68,4539,0,7,3,4659
"129",2015-05-13,13,37,61,4222,0,8,2,4343
"130",2015-05-14,8,27,68,3901,0,12,4,4020
"131",2015-05-15,9,23,40,2531,0,2,1,2606
"132",2015-05-16,3,24,23,1745,0,3,0,1798
"133",2015-05-17,5,19,25,1833,0,1,1,1884
"134",2015-05-18,6,48,68,4452,0,9,2,4585
"135",2015-05-19,8,34,73,4377,0,6,4,4502
"136",2015-05-20,8,30,71,4184,0,57,2,4352
"137",2015-05-21,4,29,62,3777,0,9,3,3884
"138",2015-05-22,9,21,42,2294,0,4,3,2373
"139",2015-05-23,1,14,31,1390,0,0,0,1436
"140",2015-05-24,4,15,35,1433,0,2,0,1489
"141",2015-05-25,3,21,34,1479,0,1,0,1538
"142",2015-05-26,11,29,58,3990,0,12,2,4102
"143",2015-05-27,5,35,69,4136,0,8,3,4256
"144",2015-05-28,7,33,49,3740,0,16,4,3849
"145",2015-05-29,15,28,43,2581,0,9,2,2678
"146",2015-05-30,4,21,22,1658,0,0,0,1705
"147",2015-05-31,12,15,34,1784,0,2,0,1847
"148",2015-06-01,7,37,55,3925,0,9,1,4034
"149",2015-06-02,16,31,64,3841,0,7,4,3963
"150",2015-06-03,10,28,67,3715,0,11,2,3833
"151",2015-06-04,8,29,39,3294,0,8,3,3381
"152",2015-06-05,12,32,48,2238,0,5,6,2341
"153",2015-06-06,5,17,27,1411,0,1,0,1461
"154",2015-06-07,9,14,23,1436,0,1,0,1483
"155",2015-06-08,12,34,40,2228,0,5,2,2321
"156",2015-06-09,10,35,39,2028,0,7,0,2119
"157",2015-06-10,4,30,35,1701,0,2,0,1772
"158",2015-06-11,11,14,24,926,0,1,0,976
"159",2015-06-12,3,24,31,875,0,3,0,936
"160",2015-06-13,2,14,13,616,0,1,0,646
"161",2015-06-14,4,16,15,544,0,2,0,581
"162",2015-06-15,0,0,0,7,0,0,0,7
"163",2015-06-16,9,22,23,622,0,2,0,678
"164",2015-06-17,7,14,16,652,0,2,0,691
"165",2015-06-18,7,16,29,638,0,3,0,693
"166",2015-06-19,9,16,19,589,0,3,0,636
"167",2015-06-20,0,0,0,0,0,0,0,0
"168",2015-06-21,0,0,0,0,0,0,0,0
"169",2015-06-22,12,19,21,1220,0,16,0,1288
"170",2015-06-23,10,24,21,1221,0,21,0,1297
"171",2015-06-24,20,20,16,1164,0,10,0,1230
"172",2015-06-25,21,22,19,1022,0,13,0,1097
"173",2015-06-26,21,26,20,794,0,9,0,870
"174",2015-06-27,12,14,6,396,0,6,0,434
"175",2015-06-28,6,13,10,455,0,1,0,485
"176",2015-06-29,22,27,31,1160,0,11,0,1251
"177",2015-06-30,12,24,25,1100,0,19,0,1180
"178",2015-07-01,20,33,19,982,0,14,0,1068
"179",2015-07-02,21,26,17,928,0,10,0,1002
"180",2015-07-03,0,0,0,0,0,0,0,0
"181",2015-07-04,0,0,0,0,0,0,0,0
"182",2015-07-05,0,0,0,0,0,0,0,0
"183",2015-07-06,23,30,26,1122,1,13,0,1215
"184",2015-07-07,14,33,18,1116,1,6,0,1188
"185",2015-07-08,21,29,18,1045,0,14,0,1127
"186",2015-07-09,13,28,20,902,0,11,0,974
"187",2015-07-10,20,28,21,827,0,5,0,901
"188",2015-07-11,11,17,9,441,0,1,0,479
"189",2015-07-12,6,18,11,431,0,4,0,470
"190",2015-07-13,20,28,18,1096,0,10,0,1172
"191",2015-07-14,19,35,24,1018,0,7,0,1103
"192",2015-07-15,19,21,17,965,0,12,0,1034
"193",2015-07-16,18,17,16,766,0,9,0,826
"194",2015-07-17,16,31,20,709,0,3,0,779
"195",2015-07-18,3,9,12,369,0,0,0,393
"196",2015-07-19,7,11,9,416,0,4,0,447
"197",2015-07-20,21,29,25,1052,0,3,0,1130
"198",2015-07-21,14,27,23,1052,0,6,0,1122
"199",2015-07-22,23,34,18,1008,0,10,0,1093
"200",2015-07-23,12,28,23,893,0,6,0,962
"201",2015-07-24,14,29,22,742,0,2,0,809
"202",2015-07-25,5,16,8,363,0,0,0,392
"203",2015-07-26,1,14,13,379,0,1,0,408
"204",2015-07-27,13,37,27,1043,0,2,0,1122
"205",2015-07-28,13,38,30,962,0,14,0,1057
"206",2015-07-29,13,31,30,969,0,1,0,1044
"207",2015-07-30,16,26,24,814,0,5,0,885
"208",2015-07-31,19,24,24,715,0,1,0,783
"209",2015-08-01,4,16,10,343,0,2,0,375
"210",2015-08-02,4,15,12,369,0,2,0,402
"211",2015-08-03,8,39,26,957,0,13,0,1043
"212",2015-08-04,6,34,33,976,0,1,0,1050
"213",2015-08-05,14,37,24,892,0,5,0,972
"214",2015-08-06,5,26,29,779,0,3,0,842
"215",2015-08-07,14,27,26,656,0,2,0,725
"216",2015-08-08,2,16,14,364,0,0,0,396
"217",2015-08-09,8,17,10,393,0,3,0,431
"218",2015-08-10,13,42,35,844,0,3,0,937
"219",2015-08-11,11,29,31,755,0,7,0,833
"220",2015-08-12,3,32,33,699,0,4,0,771
"221",2015-08-13,7,27,24,551,0,5,0,614
"222",2015-08-14,7,30,26,449,0,4,0,516
"223",2015-08-15,1,14,13,236,0,0,0,264
"224",2015-08-16,2,18,3,280,0,0,0,303
"225",2015-08-17,7,31,31,571,0,1,0,641
"226",2015-08-18,12,30,32,526,0,1,0,601
"227",2015-08-19,10,30,24,569,0,3,0,636
"228",2015-08-20,11,24,19,478,0,3,0,535
"229",2015-08-21,8,27,23,431,0,2,0,491
"230",2015-08-22,0,0,0,0,0,0,0,0
"231",2015-08-23,0,0,0,0,0,0,0,0
"232",2015-08-24,0,0,0,2,0,0,0,2
"233",2015-08-25,0,0,0,0,0,0,0,0
"234",2015-08-26,0,0,0,0,0,0,0,0
"235",2015-08-27,0,0,0,0,0,17,0,17
"236",2015-08-28,0,0,0,0,0,24,0,24
"237",2015-08-29,0,0,0,0,0,0,0,0
"238",2015-08-30,0,0,0,0,0,0,0,0
"239",2015-08-31,4,25,24,501,0,0,0,554
"240",2015-09-01,2,16,16,402,0,1,0,437
"241",2015-09-02,7,19,19,415,0,38,0,498
"242",2015-09-03,3,19,14,375,0,0,0,411
"243",2015-09-04,6,14,14,253,0,0,0,287
"244",2015-09-05,0,0,0,0,0,0,0,0
"245",2015-09-06,0,0,0,0,0,0,0,0
"246",2015-09-07,0,0,0,0,0,0,0,0
"247",2015-09-08,10,32,30,456,0,2,0,530
"248",2015-09-09,8,29,21,432,0,5,0,495
"249",2015-09-10,0,25,17,319,0,3,0,364
"250",2015-09-11,5,21,16,317,0,4,0,363
"251",2015-09-12,0,0,0,0,0,0,0,0
"252",2015-09-13,0,0,0,0,0,0,0,0
"253",2015-09-14,6,26,29,451,0,1,0,513
"254",2015-09-15,12,36,17,434,0,1,0,500
"255",2015-09-16,9,31,30,406,0,7,0,483
"256",2015-09-17,7,23,25,372,0,1,0,428
"257",2015-09-18,8,22,25,458,0,10,0,523
"258",2015-09-19,0,0,0,0,0,0,0,0
"259",2015-09-20,0,0,0,14,0,0,0,14
"260",2015-09-21,4,29,35,1184,0,23,0,1275
"261",2015-09-22,8,25,30,1381,0,7,0,1451
"262",2015-09-23,8,24,33,1513,0,9,0,1587
"263",2015-09-24,5,22,28,2230,0,21,0,2306
"264",2015-09-25,7,22,30,2275,0,4,0,2338
"265",2015-09-26,3,10,8,1472,0,2,0,1495
"266",2015-09-27,4,14,18,2272,0,0,0,2308
"267",2015-09-28,11,33,34,6299,0,17,0,6394
"268",2015-09-29,9,34,52,5900,0,12,1,6008
"269",2015-09-30,5,42,48,5048,0,7,0,5150
"270",2015-10-01,11,35,33,4698,0,3,1,4781
"271",2015-10-02,9,37,37,3099,0,1,0,3183
"272",2015-10-03,2,15,20,1812,0,0,0,1849
"273",2015-10-04,2,21,20,1918,0,0,0,1961
"274",2015-10-05,9,40,42,4946,0,8,0,5045
"275",2015-10-06,7,44,41,4643,0,6,1,4742
"276",2015-10-07,9,42,46,4385,1,6,0,4489
"277",2015-10-08,6,42,40,4116,0,5,1,4210
"278",2015-10-09,13,41,48,2757,0,0,0,2859
"279",2015-10-10,5,21,19,1054,0,2,0,1101
"280",2015-10-11,4,21,35,1959,0,0,0,2019
"281",2015-10-12,9,48,54,4945,1,10,0,5067
"282",2015-10-13,11,46,52,4964,1,10,1,5085
"283",2015-10-14,12,49,58,4345,0,6,1,4471
"284",2015-10-15,6,43,48,4242,0,4,1,4344
"285",2015-10-16,7,38,38,2833,0,4,0,2920
"286",2015-10-17,3,19,16,1552,0,1,0,1591
"287",2015-10-18,3,29,25,1803,0,1,0,1861
"288",2015-10-19,16,41,55,4076,0,7,1,4196
"289",2015-10-20,8,42,46,4479,0,9,0,4584
"290",2015-10-21,8,38,52,4063,0,7,0,4168
"291",2015-10-22,10,36,49,3849,0,5,2,3951
"292",2015-10-23,13,40,35,2556,0,3,0,2647
"293",2015-10-24,1,25,15,1555,0,0,0,1596
"294",2015-10-25,12,31,27,1698,0,2,0,1770
"295",2015-10-26,11,49,45,4421,0,7,0,4533
"296",2015-10-27,8,43,45,4058,0,10,1,4165
"297",2015-10-28,7,38,53,3926,0,10,1,4035
"298",2015-10-29,4,42,40,3615,0,7,2,3710
"299",2015-10-30,11,37,40,2377,0,0,0,2465
"300",2015-10-31,4,26,30,1417,0,0,0,1477
"301",2015-11-01,6,20,21,1602,0,1,0,1650
"302",2015-11-02,17,59,58,4312,0,7,0,4453
"303",2015-11-03,12,60,64,4364,0,7,1,4508
"304",2015-11-04,12,64,61,4223,0,11,1,4372
"305",2015-11-05,9,46,48,3968,0,5,2,4078
"306",2015-11-06,16,34,42,2638,0,6,0,2736
"307",2015-11-07,2,22,27,1289,0,0,0,1340
"308",2015-11-08,9,23,25,1705,0,0,0,1762
"309",2015-11-09,14,45,64,4463,0,4,0,4590
"310",2015-11-10,12,48,62,4385,0,7,1,4515
"311",2015-11-11,9,55,56,4017,0,6,0,4143
"312",2015-11-12,6,40,47,3742,0,4,1,3840
"313",2015-11-13,10,45,46,2592,0,2,0,2695
"314",2015-11-14,9,24,30,1686,0,1,0,1750
"315",2015-11-15,9,32,28,1716,0,1,0,1786
"316",2015-11-16,8,52,56,3903,1,4,0,4024
"317",2015-11-17,10,49,58,4074,0,4,0,4195
"318",2015-11-18,11,52,52,4085,0,5,0,4205
"319",2015-11-19,11,32,55,3803,0,5,3,3909
"320",2015-11-20,13,35,38,2506,0,4,0,2596
"321",2015-11-21,8,18,19,1024,0,0,0,1069
"322",2015-11-22,15,44,26,1607,0,0,0,1692
"323",2015-11-23,10,59,45,3708,0,4,0,3826
"324",2015-11-24,22,50,45,3005,0,4,1,3127
"325",2015-11-25,9,32,33,1564,0,2,0,1640
"326",2015-11-26,0,0,0,0,0,0,0,0
"327",2015-11-27,0,0,0,1,0,0,0,1
"328",2015-11-28,0,0,0,0,0,0,0,0
"329",2015-11-29,8,34,26,1277,0,0,0,1345
"330",2015-11-30,14,45,51,3668,0,5,0,3783
"331",2015-12-01,11,52,55,3824,1,6,1,3950
"332",2015-12-02,14,59,50,3774,0,5,1,3903
"333",2015-12-03,11,29,68,3553,0,5,1,3667
"334",2015-12-04,9,39,45,2514,0,1,0,2608
"335",2015-12-05,5,32,34,1766,0,1,0,1838
"336",2015-12-06,6,20,37,1470,0,0,0,1533
"337",2015-12-07,12,48,59,2189,1,2,0,2311
"338",2015-12-08,11,52,67,2123,0,3,0,2256
"339",2015-12-09,10,43,49,1682,0,0,0,1784
"340",2015-12-10,5,24,28,992,0,1,0,1050
"341",2015-12-11,8,33,40,818,0,0,0,899
"342",2015-12-12,0,0,0,0,0,1,0,1
"343",2015-12-13,0,0,0,0,0,0,0,0
"344",2015-12-14,16,37,41,713,0,4,0,811
"345",2015-12-15,9,42,44,598,1,0,0,694
"346",2015-12-16,11,37,33,521,0,1,0,603
"347",2015-12-17,13,30,35,498,0,0,0,576
"348",2015-12-18,9,35,32,452,0,2,0,530
"349",2015-12-19,0,0,0,0,0,0,0,0
"350",2015-12-20,0,0,0,2,0,0,0,2
"351",2015-12-21,16,31,31,397,0,2,0,477
"352",2015-12-22,7,27,30,334,0,1,0,399
"353",2015-12-23,13,29,28,283,0,1,0,354
"354",2015-12-24,0,0,0,0,0,0,0,0
"355",2015-12-25,0,0,0,0,0,0,0,0
"356",2015-12-26,0,0,0,0,0,0,0,0
"357",2015-12-27,0,0,0,0,0,0,0,0
"358",2015-12-28,11,44,35,468,1,1,0,560
"359",2015-12-29,7,25,29,410,0,1,0,472
"360",2015-12-30,7,37,23,394,0,1,0,462
"361",2015-12-31,0,0,0,0,0,0,0,0
"362",2016-01-01,0,0,0,0,0,0,0,0
"363",2016-01-02,0,0,0,0,0,0,0,0
"364",2016-01-03,0,7,17,724,0,1,0,749
"365",2016-01-04,16,54,47,4878,0,9,0,5004
"366",2016-01-05,15,49,52,5208,1,6,0,5331
"367",2016-01-06,22,56,50,4774,0,7,0,4909
"368",2016-01-07,12,51,42,4578,0,5,0,4688
"369",2016-01-08,17,43,41,3224,0,2,0,3327
"370",2016-01-09,11,32,32,2173,0,0,0,2248
"371",2016-01-10,13,29,31,2038,0,0,0,2111
"372",2016-01-11,14,62,60,5138,0,9,0,5283
"373",2016-01-12,20,61,66,5257,2,5,0,5411
"374",2016-01-13,12,68,63,5005,1,3,0,5152
"375",2016-01-14,14,55,51,4670,0,12,0,4802
"376",2016-01-15,14,42,40,2841,0,3,0,2940
"377",2016-01-16,10,27,32,1812,0,0,0,1881
"378",2016-01-17,8,33,36,1813,0,0,0,1890
"379",2016-01-18,11,49,43,2205,1,2,0,2311
"380",2016-01-19,13,49,54,5127,1,7,2,5253
"381",2016-01-20,17,68,59,4998,2,4,0,5148
"382",2016-01-21,10,50,60,4599,0,7,1,4727
"383",2016-01-22,20,46,56,3210,0,9,0,3341
"384",2016-01-23,3,31,34,2173,0,2,0,2243
"385",2016-01-24,11,39,36,2375,0,2,0,2463
"386",2016-01-25,11,61,65,4871,1,7,0,5016
"387",2016-01-26,12,59,75,4888,1,11,1,5047
"388",2016-01-27,9,54,69,4897,0,14,0,5043
"389",2016-01-28,11,50,58,4535,0,6,1,4661
"390",2016-01-29,16,44,46,2921,0,3,0,3030
"391",2016-01-30,8,26,33,2140,0,0,0,2207
"392",2016-01-31,7,34,31,2393,0,2,0,2467
"393",2016-02-01,15,59,57,4950,1,5,0,5087
"394",2016-02-02,11,43,64,4922,1,4,1,5046
"395",2016-02-03,11,59,65,4630,1,7,0,4773
"396",2016-02-04,13,37,64,4356,0,7,1,4478
"397",2016-02-05,13,52,39,2790,0,2,0,2896
"398",2016-02-06,3,29,42,2208,0,3,0,2285
"399",2016-02-07,4,22,26,1371,0,0,0,1423
"400",2016-02-08,17,58,71,4781,1,5,0,4933
"401",2016-02-09,11,48,61,4747,1,5,1,4874
"402",2016-02-10,12,57,63,4654,1,6,0,4793
"403",2016-02-11,10,45,66,4102,0,4,0,4227
"404",2016-02-12,13,47,53,2670,0,3,0,2786
"405",2016-02-13,9,23,37,1822,0,0,0,1891
"406",2016-02-14,10,28,41,1879,0,1,0,1959
"407",2016-02-15,17,54,71,4610,2,5,0,4759
"408",2016-02-16,12,52,71,4770,1,4,1,4911
"409",2016-02-17,9,50,77,4532,1,5,0,4674
"410",2016-02-18,12,37,79,4046,0,3,1,4178
"411",2016-02-19,10,44,67,2823,0,6,0,2950
"412",2016-02-20,3,31,48,1867,0,0,0,1949
"413",2016-02-21,7,34,37,2073,0,0,0,2151
"414",2016-02-22,18,50,80,4757,0,4,0,4909
"415",2016-02-23,8,49,68,4709,1,4,1,4840
"416",2016-02-24,6,54,69,4213,0,5,0,4347
"417",2016-02-25,5,38,61,4065,0,4,1,4174
"418",2016-02-26,8,46,68,2730,0,2,0,2854
"419",2016-02-27,3,38,40,1990,0,2,0,2073
"420",2016-02-28,12,23,50,1942,0,0,0,2027
"421",2016-02-29,11,54,71,4610,1,9,0,4756
"422",2016-03-01,12,48,77,4584,1,4,1,4727
"423",2016-03-02,10,51,72,4296,1,5,0,4435
"424",2016-03-03,9,44,76,4187,0,4,1,4321
"425",2016-03-04,4,38,52,2701,0,3,0,2798
"426",2016-03-05,5,37,36,1758,0,2,0,1838
"427",2016-03-06,12,24,58,2054,0,1,0,2149
"428",2016-03-07,10,62,73,4513,0,6,0,4664
"429",2016-03-08,10,44,74,4134,0,6,0,4268
"430",2016-03-09,15,49,57,4085,0,12,0,4218
"431",2016-03-10,6,47,70,3980,0,4,1,4108
"432",2016-03-11,11,38,58,2576,0,2,0,2685
"433",2016-03-12,6,34,30,1857,0,1,0,1928
"434",2016-03-13,10,34,37,1855,0,0,0,1936
"435",2016-03-14,8,51,62,2542,0,5,0,2668
"436",2016-03-15,13,50,64,2320,0,4,0,2451
"437",2016-03-16,19,53,55,2026,0,2,0,2155
"438",2016-03-17,5,32,28,1016,0,2,0,1083
"439",2016-03-18,5,19,23,779,0,1,0,827
"440",2016-03-19,0,0,0,0,0,0,0,0
"441",2016-03-20,0,0,0,0,0,0,0,0
"442",2016-03-21,6,42,33,636,0,3,0,720
"443",2016-03-22,9,33,36,494,0,2,0,574
"444",2016-03-23,8,41,26,502,0,1,0,578
"445",2016-03-24,6,24,19,521,0,2,0,572
"446",2016-03-25,4,22,22,526,0,9,0,583
"447",2016-03-26,0,0,0,0,0,0,0,0
"448",2016-03-27,2,13,8,767,0,0,0,790
"449",2016-03-28,9,60,32,5234,0,12,2,5349
"450",2016-03-29,14,56,27,5228,0,7,0,5332
"451",2016-03-30,7,50,44,5075,0,9,0,5185
"452",2016-03-31,9,38,40,4501,0,6,0,4594
"453",2016-04-01,5,26,33,2627,0,2,0,2693
"454",2016-04-02,1,29,27,1698,0,1,0,1756
"455",2016-04-03,2,31,19,2149,0,1,0,2202
"456",2016-04-04,6,56,62,5218,0,8,0,5350
"457",2016-04-05,8,64,57,5322,0,4,0,5455
"458",2016-04-06,9,51,60,4992,0,7,0,5119
"459",2016-04-07,9,55,49,4079,0,3,0,4195
"460",2016-04-08,6,47,37,2674,0,0,0,2764
"461",2016-04-09,4,22,20,1722,0,0,0,1768
"462",2016-04-10,8,47,27,2021,0,2,0,2105
"463",2016-04-11,11,56,68,4822,1,5,2,4965
"464",2016-04-12,8,67,71,4617,0,6,0,4769
"465",2016-04-13,11,64,59,4411,0,6,0,4551
"466",2016-04-14,8,41,52,4053,0,5,0,4159
"467",2016-04-15,5,51,41,2878,0,1,0,2976
"468",2016-04-16,7,39,33,1621,0,0,0,1700
"469",2016-04-17,6,35,23,1703,0,0,0,1767
"470",2016-04-18,10,66,72,4379,0,10,0,4537
"471",2016-04-19,8,55,59,4468,0,3,0,4593
"472",2016-04-20,9,54,43,3940,0,5,0,4051
"473",2016-04-21,5,47,50,3997,0,10,0,4109
"474",2016-04-22,9,41,47,2791,0,0,0,2888
"475",2016-04-23,3,36,35,1780,0,0,0,1854
"476",2016-04-24,8,40,31,1812,0,0,0,1891
"477",2016-04-25,12,51,53,4416,0,11,0,4543
"478",2016-04-26,11,54,65,4327,0,3,0,4460
"479",2016-04-27,15,58,47,4235,0,8,0,4363
"480",2016-04-28,8,51,40,3850,0,5,0,3954
"481",2016-04-29,5,50,42,2608,0,0,0,2705
"482",2016-04-30,2,34,22,1320,0,0,0,1378
"483",2016-05-01,4,28,23,1690,0,0,0,1745
"484",2016-05-02,7,53,50,4398,0,8,0,4516
"485",2016-05-03,8,56,62,4706,0,4,0,4836
"486",2016-05-04,6,62,65,4362,0,6,0,4501
"487",2016-05-05,8,63,42,3818,0,3,0,3934
"488",2016-05-06,4,38,42,2172,0,1,0,2257
"489",2016-05-07,6,22,20,1199,0,0,0,1247
"490",2016-05-08,3,32,27,1504,0,0,0,1566
"491",2016-05-09,8,51,59,4237,0,6,2,4363
"492",2016-05-10,7,58,57,4262,0,4,0,4388
"493",2016-05-11,11,54,65,4124,0,7,0,4261
"494",2016-05-12,7,43,46,3859,0,4,0,3959
"495",2016-05-13,4,48,36,2426,0,6,0,2520
"496",2016-05-14,6,27,31,1766,0,2,0,1832
"497",2016-05-15,8,35,26,1701,0,1,0,1771
"498",2016-05-16,7,58,52,4117,0,6,1,4241
"499",2016-05-17,8,57,53,4150,0,5,0,4273
"500",2016-05-18,8,52,52,3905,0,7,0,4024
"501",2016-05-19,4,47,48,3376,0,3,0,3478
"502",2016-05-20,10,45,36,2184,0,2,0,2277
"503",2016-05-21,3,26,34,1435,0,2,0,1500
"504",2016-05-22,6,30,30,1449,0,1,0,1516
"505",2016-05-23,14,45,53,3804,0,9,1,3926
"506",2016-05-24,7,43,49,3819,0,3,0,3921
"507",2016-05-25,8,36,54,3620,0,7,0,3725
"508",2016-05-26,7,45,51,3253,0,3,0,3359
"509",2016-05-27,8,34,30,2017,0,2,0,2091
"510",2016-05-28,3,24,24,1232,0,0,0,1283
"511",2016-05-29,5,29,21,1358,0,2,0,1415
"512",2016-05-30,5,32,24,1316,0,0,0,1377
"513",2016-05-31,3,52,44,3590,0,4,0,3693
"514",2016-06-01,12,41,53,3635,0,5,0,3746
"515",2016-06-02,8,47,45,3363,0,3,0,3466
"516",2016-06-03,8,40,43,2129,0,5,0,2225
"517",2016-06-04,5,31,31,1377,0,0,0,1444
"518",2016-06-05,6,30,25,1527,0,0,0,1588
"519",2016-06-06,8,45,35,2249,0,5,0,2342
"520",2016-06-07,8,52,45,1898,0,0,0,2003
"521",2016-06-08,1,46,32,1614,0,0,0,1693
"522",2016-06-09,6,29,26,1126,0,1,0,1188
"523",2016-06-10,8,33,22,784,0,3,0,850
"524",2016-06-11,6,10,10,0,0,0,0,26
"525",2016-06-12,3,9,13,0,0,0,0,25
"526",2016-06-13,7,24,24,401,0,4,0,460
"527",2016-06-14,7,27,25,543,0,2,0,604
"528",2016-06-15,6,35,21,540,0,1,0,603
"529",2016-06-16,8,28,18,510,0,0,0,564
"530",2016-06-17,0,27,21,484,0,0,0,532
"531",2016-06-18,0,0,0,0,0,0,0,0
"532",2016-06-19,0,0,0,0,0,0,0,0
"533",2016-06-20,10,23,29,1252,0,41,0,1355
"534",2016-06-21,18,27,30,942,0,30,0,1047
"535",2016-06-22,13,27,26,860,0,30,0,956
"536",2016-06-23,19,17,27,746,0,18,0,827
"537",2016-06-24,16,21,26,670,0,35,0,768
"538",2016-06-25,6,13,17,332,0,4,0,372
"539",2016-06-26,4,19,10,317,0,14,0,364
"540",2016-06-27,17,36,38,928,0,21,0,1040
"541",2016-06-28,18,40,35,953,0,11,0,1057
"542",2016-06-29,17,35,37,803,0,10,0,902
"543",2016-06-30,12,22,27,759,0,8,0,828
"544",2016-07-01,17,37,33,667,0,8,0,762
"545",2016-07-02,5,8,11,328,0,5,0,357
"546",2016-07-03,6,16,17,316,0,6,0,361
"547",2016-07-04,3,19,22,254,0,8,0,306
"548",2016-07-05,14,25,38,713,0,11,0,801
"549",2016-07-06,10,33,28,812,0,8,0,891
"550",2016-07-07,11,25,34,791,0,12,0,873
"551",2016-07-08,12,26,25,634,0,16,0,713
"552",2016-07-09,5,18,19,414,0,4,0,460
"553",2016-07-10,4,13,14,346,0,7,0,384
"554",2016-07-11,21,35,29,849,0,8,0,942
"555",2016-07-12,11,26,26,820,0,8,0,891
"556",2016-07-13,7,28,23,761,0,2,0,821
"557",2016-07-14,8,21,33,627,0,0,0,689
"558",2016-07-15,19,27,34,534,0,13,0,627
"559",2016-07-16,5,15,19,310,0,4,0,353
"560",2016-07-17,8,14,16,340,0,2,0,380
"561",2016-07-18,18,29,25,797,0,10,0,879
"562",2016-07-19,14,27,36,800,0,9,0,886
"563",2016-07-20,14,30,32,727,0,5,0,808
"564",2016-07-21,13,23,27,699,0,7,0,769
"565",2016-07-22,11,27,27,574,0,2,0,641
"566",2016-07-23,8,15,14,275,0,3,0,315
"567",2016-07-24,8,19,21,286,0,3,0,337
"568",2016-07-25,10,35,39,746,0,5,0,835
"569",2016-07-26,6,28,29,741,0,2,0,806
"570",2016-07-27,8,30,34,739,0,6,0,817
"571",2016-07-28,3,25,34,669,0,3,0,734
"572",2016-07-29,9,29,23,530,0,3,0,594
"573",2016-07-30,1,20,20,255,0,0,0,296
"574",2016-07-31,3,19,18,312,0,1,0,353
"575",2016-08-01,9,32,36,727,0,2,0,806
"576",2016-08-02,6,37,37,676,0,3,0,759
"577",2016-08-03,9,32,35,717,0,5,0,798
"578",2016-08-04,4,30,38,680,0,5,0,757
"579",2016-08-05,12,36,32,607,0,1,0,688
"580",2016-08-06,1,12,17,275,0,1,0,306
"581",2016-08-07,7,19,21,306,0,1,0,354
"582",2016-08-08,4,33,36,634,0,0,0,707
"583",2016-08-09,10,25,32,632,0,1,0,700
"584",2016-08-10,13,40,43,560,0,4,0,660
"585",2016-08-11,5,29,32,481,0,2,0,549
"586",2016-08-12,11,30,22,400,0,2,0,465
"587",2016-08-13,3,19,21,211,0,2,0,256
"588",2016-08-14,4,16,18,223,0,0,0,261
"589",2016-08-15,5,27,33,499,0,1,0,565
"590",2016-08-16,14,27,37,486,0,1,0,565
"591",2016-08-17,9,32,31,497,0,2,0,571
"592",2016-08-18,10,20,24,403,0,1,0,458
"593",2016-08-19,12,33,26,343,0,1,0,415
"594",2016-08-20,0,0,0,0,0,0,0,0
"595",2016-08-21,0,0,0,0,0,0,0,0
"596",2016-08-22,0,0,0,0,0,0,0,0
"597",2016-08-23,0,0,0,0,0,10,0,10
"598",2016-08-24,0,0,0,0,0,0,0,0
"599",2016-08-25,0,0,0,0,0,0,0,0
"600",2016-08-26,0,0,0,1,0,8,0,9
"601",2016-08-27,0,0,0,0,0,0,0,0
"602",2016-08-28,0,0,0,0,0,0,0,0
"603",2016-08-29,7,24,31,444,0,0,0,506
"604",2016-08-30,5,19,25,386,0,0,0,435
"605",2016-08-31,7,25,30,354,0,1,0,417
"606",2016-09-01,3,12,26,330,0,2,0,373
"607",2016-09-02,9,25,22,267,0,0,1,324
"608",2016-09-03,0,0,0,0,0,0,0,0
"609",2016-09-04,0,0,0,0,0,0,0,0
"610",2016-09-05,0,0,0,0,0,0,0,0
"611",2016-09-06,13,34,33,352,0,2,1,435
"612",2016-09-07,5,30,39,402,0,1,0,477
"613",2016-09-08,7,22,32,300,0,3,0,364
"614",2016-09-09,8,27,25,262,0,3,0,325
"615",2016-09-10,0,0,0,0,0,0,0,0
"616",2016-09-11,0,0,1,0,0,0,0,1
"617",2016-09-12,17,35,37,319,0,2,0,410
"618",2016-09-13,13,28,29,342,0,6,1,419
"619",2016-09-14,13,25,38,297,0,3,2,378
"620",2016-09-15,8,22,30,294,0,1,0,355
"621",2016-09-16,10,23,36,257,0,2,0,328
"622",2016-09-17,0,0,0,1,0,0,0,1
"623",2016-09-18,0,0,0,1,0,0,0,1
"624",2016-09-19,2,25,40,998,0,27,1,1093
"625",2016-09-20,7,26,38,1150,0,9,1,1231
"626",2016-09-21,4,22,41,1253,0,10,1,1331
"627",2016-09-22,2,25,41,2356,0,9,1,2434
"628",2016-09-23,9,19,32,2353,0,20,2,2435
"629",2016-09-24,2,4,9,1159,0,3,0,1177
"630",2016-09-25,1,16,23,2376,0,1,1,2418
"631",2016-09-26,6,47,46,5999,0,33,0,6131
"632",2016-09-27,10,40,52,5526,0,32,0,5660
"633",2016-09-28,7,44,45,4829,0,23,0,4948
"634",2016-09-29,8,39,51,4275,0,18,0,4391
"635",2016-09-30,12,38,53,3204,0,8,0,3315
"636",2016-10-01,4,23,28,1785,0,1,0,1841
"637",2016-10-02,3,26,31,1951,0,2,0,2013
"638",2016-10-03,12,53,65,4559,0,21,0,4710
"639",2016-10-04,10,52,65,4415,0,25,0,4567
"640",2016-10-05,16,67,68,4528,0,19,0,4698
"641",2016-10-06,8,43,61,3981,0,18,0,4111
"642",2016-10-07,9,39,38,2671,0,9,0,2766
"643",2016-10-08,3,25,20,1061,0,1,0,1110
"644",2016-10-09,0,34,23,1734,0,0,0,1791
"645",2016-10-10,11,61,47,4391,0,15,0,4525
"646",2016-10-11,6,54,61,4406,0,26,0,4553
"647",2016-10-12,8,60,59,4102,0,20,0,4249
"648",2016-10-13,6,39,47,3629,0,25,2,3748
"649",2016-10-14,8,44,42,2620,0,6,0,2720
"650",2016-10-15,11,30,26,1787,0,0,0,1854
"651",2016-10-16,9,31,33,1706,0,2,0,1781
"652",2016-10-17,5,53,60,4023,0,18,0,4159
"653",2016-10-18,10,49,54,4132,0,21,0,4266
"654",2016-10-19,18,58,58,3936,0,17,0,4087
"655",2016-10-20,11,36,44,3455,0,25,0,3571
"656",2016-10-21,20,37,35,2530,0,4,0,2626
"657",2016-10-22,4,24,23,1464,0,1,0,1516
"658",2016-10-23,8,36,21,1587,0,1,0,1653
"659",2016-10-24,14,52,59,3973,0,18,0,4116
"660",2016-10-25,12,47,57,3933,0,28,2,4079
"661",2016-10-26,21,48,55,3811,0,24,0,3959
"662",2016-10-27,13,35,49,3426,0,26,1,3550
"663",2016-10-28,13,44,35,2068,0,6,2,2168
"664",2016-10-29,3,21,22,856,0,0,0,902
"665",2016-10-30,6,30,31,1480,0,0,1,1548
"666",2016-10-31,9,58,48,3636,0,22,1,3774
"667",2016-11-01,13,54,51,3965,0,23,4,4110
"668",2016-11-02,13,59,62,3897,0,21,1,4053
"669",2016-11-03,12,47,58,3811,0,28,2,3958
"670",2016-11-04,12,39,47,2645,0,4,0,2747
"671",2016-11-05,2,29,36,2151,0,2,0,2220
"672",2016-11-06,3,28,26,2192,0,2,1,2252
"673",2016-11-07,15,59,58,3942,0,24,0,4098
"674",2016-11-08,13,47,52,3963,0,26,3,4104
"675",2016-11-09,14,55,42,3579,0,22,1,3713
"676",2016-11-10,8,53,51,3506,0,21,2,3641
"677",2016-11-11,13,39,53,2424,0,6,0,2535
"678",2016-11-12,1,24,27,1086,0,0,0,1138
"679",2016-11-13,5,32,32,1764,0,3,1,1837
"680",2016-11-14,17,59,64,4036,0,24,0,4200
"681",2016-11-15,18,58,62,3994,0,25,3,4160
"682",2016-11-16,14,66,66,3827,0,27,0,4000
"683",2016-11-17,7,50,54,3477,0,23,1,3612
"684",2016-11-18,16,55,46,2412,0,8,0,2537
"685",2016-11-19,8,31,25,1667,0,0,2,1733
"686",2016-11-20,5,37,30,1551,0,5,1,1629
"687",2016-11-21,20,59,71,3481,0,22,0,3653
"688",2016-11-22,14,50,57,2927,0,22,2,3072
"689",2016-11-23,10,47,39,1531,0,24,0,1651
"690",2016-11-24,0,0,0,0,0,0,0,0
"691",2016-11-25,0,0,0,0,0,0,0,0
"692",2016-11-26,0,0,0,0,0,0,0,0
"693",2016-11-27,11,36,28,1097,0,3,1,1176
"694",2016-11-28,16,41,62,3610,0,23,1,3753
"695",2016-11-29,14,50,59,3766,0,20,2,3911
"696",2016-11-30,17,50,53,3503,0,24,0,3647
"697",2016-12-01,12,45,48,3344,0,24,1,3474
"698",2016-12-02,17,48,55,2379,0,10,0,2509
"699",2016-12-03,2,33,35,1664,0,1,0,1735
"700",2016-12-04,9,27,43,1534,0,4,0,1617
"701",2016-12-05,14,62,56,2309,0,5,0,2446
"702",2016-12-06,19,45,59,2144,0,7,1,2275
"703",2016-12-07,11,58,47,1780,0,7,0,1903
"704",2016-12-08,9,37,57,1160,0,5,1,1269
"705",2016-12-09,13,47,50,961,0,5,0,1076
"706",2016-12-10,0,0,0,0,0,0,0,0
"707",2016-12-11,0,0,0,0,0,0,0,0
"708",2016-12-12,17,56,58,918,0,2,1,1052
"709",2016-12-13,10,37,48,612,0,7,1,715
"710",2016-12-14,12,42,48,438,0,1,0,541
"711",2016-12-15,0,0,0,0,0,0,0,0
"712",2016-12-16,0,0,0,0,0,0,0,0
"713",2016-12-17,0,0,0,0,0,0,0,0
"714",2016-12-18,0,0,0,0,0,0,0,0
"715",2016-12-19,5,45,55,429,0,0,1,535
"716",2016-12-20,8,39,41,383,0,3,1,475
"717",2016-12-21,9,39,35,295,0,1,0,379
"718",2016-12-22,4,34,41,261,0,3,1,344
"719",2016-12-23,5,32,39,199,0,4,0,279
"720",2016-12-24,0,0,0,0,0,0,0,0
"721",2016-12-25,0,0,0,0,0,0,0,0
"722",2016-12-26,0,0,0,0,0,0,0,0
"723",2016-12-27,12,40,48,323,0,4,1,428
"724",2016-12-28,9,41,32,311,0,3,0,396
"725",2016-12-29,9,40,41,312,0,1,1,404
"726",2016-12-30,7,31,35,315,0,4,2,394
"727",2016-12-31,0,0,0,0,0,0,0,0
"728",2017-01-01,0,0,0,0,0,0,0,0
"729",2017-01-02,0,0,0,0,0,0,0,0
"730",2017-01-03,9,42,49,587,0,4,0,691
"731",2017-01-04,2,14,21,221,0,2,0,260
"732",2017-01-05,6,25,39,531,0,7,0,608
"733",2017-01-06,6,34,41,678,0,7,0,766
"734",2017-01-07,0,0,0,0,0,0,0,0
"735",2017-01-08,1,16,19,908,0,1,1,946
"736",2017-01-09,16,47,44,3148,0,8,0,3263
"737",2017-01-10,21,47,69,5247,0,25,0,5409
"738",2017-01-11,22,61,58,5147,0,30,0,5318
"739",2017-01-12,16,39,59,4547,0,22,1,4684
"740",2017-01-13,15,63,50,3075,0,7,2,3212
"741",2017-01-14,13,28,32,1893,0,1,0,1967
"742",2017-01-15,8,44,34,2167,0,7,1,2261
"743",2017-01-16,9,40,36,2612,0,4,0,2701
"744",2017-01-17,15,61,67,5247,0,16,1,5407
"745",2017-01-18,29,71,66,5268,0,31,1,5466
"746",2017-01-19,13,54,65,4519,0,17,3,4671
"747",2017-01-20,19,62,51,3329,0,11,0,3472
"748",2017-01-21,4,28,31,1954,0,1,2,2020
"749",2017-01-22,15,44,27,2217,0,3,2,2308
"750",2017-01-23,17,67,73,5320,0,31,1,5509
"751",2017-01-24,20,69,79,5040,0,22,2,5232
"752",2017-01-25,20,57,77,4695,0,24,3,4876
"753",2017-01-26,19,56,76,4570,0,25,4,4750
"754",2017-01-27,17,58,57,2912,0,13,2,3059
"755",2017-01-28,6,28,33,1996,0,4,3,2070
"756",2017-01-29,7,33,32,2271,0,4,1,2348
"757",2017-01-30,15,51,74,4642,0,32,2,4816
"758",2017-01-31,18,63,74,4707,0,19,2,4883
"759",2017-02-01,15,48,64,4556,0,32,2,4717
"760",2017-02-02,19,45,64,4092,0,23,4,4247
"761",2017-02-03,13,57,49,2803,0,10,2,2934
"762",2017-02-04,10,36,42,1947,0,8,1,2044
"763",2017-02-05,10,38,32,1607,0,7,2,1696
"764",2017-02-06,13,57,70,4626,0,30,2,4798
"765",2017-02-07,12,67,70,4820,0,24,2,4995
"766",2017-02-08,15,54,64,4691,0,33,1,4858
"767",2017-02-09,15,47,65,4344,0,19,5,4495
"768",2017-02-10,12,52,57,2909,0,15,3,3048
"769",2017-02-11,10,30,42,1893,0,9,1,1985
"770",2017-02-12,9,37,39,2116,0,6,1,2208
"771",2017-02-13,11,59,94,4435,0,21,2,4622
"772",2017-02-14,16,49,67,4141,0,21,2,4296
"773",2017-02-15,11,48,68,4537,0,20,2,4686
"774",2017-02-16,20,51,73,4093,0,35,4,4276
"775",2017-02-17,19,58,61,2932,0,14,2,3086
"776",2017-02-18,11,34,33,1597,0,0,1,1676
"777",2017-02-19,12,55,35,2024,0,4,1,2131
"778",2017-02-20,14,69,78,4607,0,26,4,4798
"779",2017-02-21,14,54,70,4483,0,17,1,4639
"780",2017-02-22,10,72,66,4292,0,21,4,4465
"781",2017-02-23,12,42,58,4116,0,15,2,4245
"782",2017-02-24,11,41,48,2801,0,12,3,2916
"783",2017-02-25,3,36,19,1681,0,4,1,1744
"784",2017-02-26,11,45,41,2210,0,5,2,2314
"785",2017-02-27,13,55,69,4236,0,24,4,4401
"786",2017-02-28,16,53,71,4547,0,18,1,4706
"787",2017-03-01,19,53,70,4521,0,27,3,4693
"788",2017-03-02,13,41,58,3854,0,14,3,3983
"789",2017-03-03,17,40,48,2741,0,4,3,2853
"790",2017-03-04,6,30,35,1782,0,4,1,1858
"791",2017-03-05,12,35,38,1895,0,7,1,1988
"792",2017-03-06,14,63,76,4192,0,21,2,4368
"793",2017-03-07,15,58,72,4399,0,14,2,4560
"794",2017-03-08,11,54,69,4150,0,31,3,4318
"795",2017-03-09,21,61,57,4138,0,19,2,4298
"796",2017-03-10,13,48,44,2681,0,10,3,2799
"797",2017-03-11,8,37,26,1885,0,3,1,1960
"798",2017-03-12,3,29,32,1719,0,2,1,1786
"799",2017-03-13,17,58,63,4347,0,23,2,4510
"800",2017-03-14,15,52,70,4098,0,18,2,4255
"801",2017-03-15,12,52,67,4069,0,24,2,4226
"802",2017-03-16,10,53,50,3853,0,23,3,3992
"803",2017-03-17,13,46,51,2607,0,14,2,2733
"804",2017-03-18,9,32,50,1876,0,4,1,1972
"805",2017-03-19,4,35,30,1678,0,8,4,1759
"806",2017-03-20,13,51,67,2481,0,11,2,2625
"807",2017-03-21,12,50,55,2249,0,8,1,2375
"808",2017-03-22,15,50,64,1867,0,5,3,2004
"809",2017-03-23,10,41,27,1092,0,5,1,1176
"810",2017-03-24,13,32,28,743,0,4,3,823
"811",2017-03-25,0,0,0,0,0,0,0,0
"812",2017-03-26,0,0,0,0,0,0,0,0
"813",2017-03-27,9,43,25,625,0,6,3,711
"814",2017-03-28,15,37,28,611,0,1,3,695
"815",2017-03-29,11,36,25,510,0,3,3,588
"816",2017-03-30,6,37,29,495,0,4,2,573
"817",2017-03-31,11,36,20,517,0,1,2,587
"818",2017-04-01,0,0,0,0,0,0,0,0
"819",2017-04-02,2,13,13,820,0,9,1,858
"820",2017-04-03,14,50,43,5136,0,30,3,5276
"821",2017-04-04,22,54,47,5075,0,31,2,5231
"822",2017-04-05,16,54,51,5056,0,28,3,5208
"823",2017-04-06,11,46,46,4682,0,25,3,4813
"824",2017-04-07,10,52,47,2981,0,12,2,3104
"825",2017-04-08,4,27,33,2041,0,4,2,2111
"826",2017-04-09,7,29,32,1894,0,7,2,1971
"827",2017-04-10,25,64,65,5255,0,35,2,5446
"828",2017-04-11,12,36,46,4712,0,21,3,4830
"829",2017-04-12,11,52,55,4790,0,28,2,4938
"830",2017-04-13,16,58,62,4196,0,30,2,4364
"831",2017-04-14,14,56,50,2785,0,14,4,2923
"832",2017-04-15,4,22,37,1381,0,4,2,1450
"833",2017-04-16,7,17,24,1292,0,2,3,1345
"834",2017-04-17,12,48,59,4619,0,39,3,4780
"835",2017-04-18,16,46,63,4720,0,30,2,4877
"836",2017-04-19,12,59,56,4614,0,51,3,4795
"837",2017-04-20,9,47,45,3706,0,34,2,3843
"838",2017-04-21,9,35,45,2444,0,8,3,2544
"839",2017-04-22,12,29,38,1692,0,6,2,1779
"840",2017-04-23,9,22,35,1757,0,6,0,1829
"841",2017-04-24,16,56,63,4409,0,28,3,4575
"842",2017-04-25,17,53,63,4300,0,30,0,4463
"843",2017-04-26,18,43,54,4263,0,37,3,4418
"844",2017-04-27,14,38,52,3835,0,31,2,3972
"845",2017-04-28,18,36,46,2482,0,11,2,2595
"846",2017-04-29,3,28,26,1178,0,3,2,1240
"847",2017-04-30,13,19,21,1876,0,8,2,1939
"848",2017-05-01,7,51,68,4405,0,29,3,4563
"849",2017-05-02,17,47,52,4111,0,29,0,4256
"850",2017-05-03,6,53,50,4417,0,33,2,4561
"851",2017-05-04,16,41,43,3716,0,32,2,3850
"852",2017-05-05,11,43,56,2451,0,13,3,2577
"853",2017-05-06,3,19,29,1471,0,7,2,1531
"854",2017-05-07,3,24,31,1543,0,6,0,1607
"855",2017-05-08,6,47,60,4312,0,31,0,4456
"856",2017-05-09,14,50,59,4137,0,31,1,4292
"857",2017-05-10,11,39,59,3927,0,26,1,4063
"858",2017-05-11,15,35,50,3481,0,26,2,3609
"859",2017-05-12,21,36,49,2366,0,13,2,2487
"860",2017-05-13,6,26,30,1494,0,1,2,1559
"861",2017-05-14,4,20,20,1457,0,8,2,1511
"862",2017-05-15,18,49,59,4281,0,31,1,4439
"863",2017-05-16,13,43,59,3920,0,32,2,4069
"864",2017-05-17,9,59,62,3943,0,23,2,4098
"865",2017-05-18,14,40,62,3437,0,22,0,3575
"866",2017-05-19,10,37,39,2065,0,9,2,2162
"867",2017-05-20,3,17,25,1194,0,3,2,1244
"868",2017-05-21,5,25,27,1368,0,6,2,1433
"869",2017-05-22,9,57,58,4066,0,27,0,4217
"870",2017-05-23,16,42,54,3729,0,25,0,3866
"871",2017-05-24,9,35,52,3809,0,25,3,3933
"872",2017-05-25,7,36,46,3139,0,22,2,3252
"873",2017-05-26,10,27,35,1818,0,9,3,1902
"874",2017-05-27,6,21,15,964,0,1,2,1009
"875",2017-05-28,0,19,23,967,0,3,2,1014
"876",2017-05-29,2,21,22,1131,0,2,2,1180
"877",2017-05-30,12,40,43,3478,0,25,2,3600
"878",2017-05-31,12,38,52,3809,0,24,0,3935
"879",2017-06-01,6,32,45,3179,0,24,2,3288
"880",2017-06-02,18,37,36,2126,0,9,3,2229
"881",2017-06-03,4,10,28,1334,0,3,2,1381
"882",2017-06-04,5,28,15,1340,0,3,2,1393
"883",2017-06-05,11,39,47,3631,0,30,3,3761
"884",2017-06-06,7,34,48,3293,0,23,2,3407
"885",2017-06-07,10,41,35,3330,0,20,4,3440
"886",2017-06-08,11,37,41,3147,0,25,2,3263
"887",2017-06-09,9,27,31,1961,0,11,2,2041
"888",2017-06-10,3,29,29,1329,0,4,2,1396
"889",2017-06-11,5,27,21,1107,0,3,2,1165
"890",2017-06-12,7,27,33,1685,0,4,3,1759
"891",2017-06-13,14,38,39,1635,0,3,2,1731
"892",2017-06-14,10,35,26,1355,0,6,2,1434
"893",2017-06-15,8,22,19,814,0,4,2,869
"894",2017-06-16,3,22,21,693,0,6,1,746
"895",2017-06-17,5,17,9,339,0,7,2,379
"896",2017-06-18,2,16,11,296,0,10,2,337
"897",2017-06-19,3,21,20,371,0,9,0,424
"898",2017-06-20,6,21,22,445,0,10,3,507
"899",2017-06-21,4,24,22,482,0,8,2,542
"900",2017-06-22,9,16,20,454,0,9,2,510
"901",2017-06-23,5,20,22,420,0,12,2,481
"902",2017-06-24,0,0,0,0,0,0,0,0
"903",2017-06-25,0,0,0,0,0,0,0,0
"904",2017-06-26,13,19,25,720,0,15,2,794
"905",2017-06-27,12,21,22,847,0,34,2,938
"906",2017-06-28,16,25,28,795,0,29,0,893
"907",2017-06-29,9,23,26,704,0,13,2,777
"908",2017-06-30,8,24,26,536,0,24,3,621
"909",2017-07-01,5,6,15,259,0,7,0,292
"910",2017-07-02,5,11,10,283,0,8,0,317
"911",2017-07-03,7,25,29,715,0,16,2,794
"912",2017-07-04,0,0,0,0,0,0,0,0
"913",2017-07-05,7,24,31,669,0,21,2,754
"914",2017-07-06,12,28,25,706,0,18,0,789
"915",2017-07-07,9,20,33,590,0,19,0,671
"916",2017-07-08,4,12,14,270,0,8,0,308
"917",2017-07-09,10,11,23,264,0,7,0,315
"918",2017-07-10,10,29,35,809,0,17,0,900
"919",2017-07-11,13,21,26,761,0,21,1,843
"920",2017-07-12,8,26,27,718,0,19,1,799
"921",2017-07-13,18,20,27,637,0,27,1,730
"922",2017-07-14,9,21,27,548,0,24,1,630
"923",2017-07-15,2,10,19,293,0,9,0,333
"924",2017-07-16,2,12,15,275,0,11,0,315
"925",2017-07-17,9,36,32,741,0,30,2,850
"926",2017-07-18,10,30,20,669,0,34,3,766
"927",2017-07-19,14,23,30,664,0,22,2,755
"928",2017-07-20,12,17,20,543,0,19,2,613
"929",2017-07-21,4,24,22,472,0,19,2,543
"930",2017-07-22,3,7,16,205,0,3,0,234
"931",2017-07-23,3,13,23,258,0,4,0,301
"932",2017-07-24,12,23,29,681,0,21,2,768
"933",2017-07-25,13,19,30,704,0,17,2,785
"934",2017-07-26,16,26,31,679,0,22,2,776
"935",2017-07-27,12,17,25,625,0,25,2,706
"936",2017-07-28,12,17,33,475,0,15,2,554
"937",2017-07-29,1,9,18,206,0,3,0,237
"938",2017-07-30,4,14,20,208,0,4,0,250
"939",2017-07-31,16,28,30,644,0,11,2,731
"940",2017-08-01,7,26,33,614,0,17,2,699
"941",2017-08-02,10,20,33,580,0,10,2,655
"942",2017-08-03,10,13,23,489,0,16,2,553
"943",2017-08-04,7,23,27,482,0,12,2,553
"944",2017-08-05,4,10,17,221,0,5,0,257
"945",2017-08-06,4,22,24,274,0,5,0,329
"946",2017-08-07,10,27,38,656,0,16,2,749
"947",2017-08-08,8,20,35,623,0,16,2,704
"948",2017-08-09,15,30,30,597,0,17,2,691
"949",2017-08-10,13,18,27,523,0,19,2,602
"950",2017-08-11,14,25,21,432,0,20,2,514
"951",2017-08-12,2,13,17,195,0,2,0,229
"952",2017-08-13,6,16,18,225,0,8,0,273
"953",2017-08-14,15,25,29,551,0,16,2,638
"954",2017-08-15,10,17,26,486,0,22,2,563
"955",2017-08-16,13,20,28,429,0,20,2,512
"956",2017-08-17,11,17,32,397,0,18,2,477
"957",2017-08-18,10,24,21,402,0,14,2,473
"958",2017-08-19,0,0,0,0,0,0,0,0
"959",2017-08-20,0,0,0,0,0,0,0,0
"960",2017-08-21,6,12,27,372,0,9,2,428
"961",2017-08-22,16,20,33,438,0,19,2,528
"962",2017-08-23,9,27,23,417,0,11,2,489
"963",2017-08-24,16,20,25,403,0,12,2,478
"964",2017-08-25,14,23,22,378,0,14,2,453
"965",2017-08-26,0,0,0,0,0,0,0,0
"966",2017-08-27,0,0,0,0,0,0,0,0
"967",2017-08-28,0,0,0,0,0,0,0,0
"968",2017-08-29,0,0,0,1,0,1,0,2
"969",2017-08-30,0,0,0,0,0,2,0,2
"970",2017-08-31,0,0,0,0,0,0,0,0
"971",2017-09-01,0,0,0,0,0,0,0,0
"972",2017-09-02,0,0,0,0,0,0,0,0
"973",2017-09-03,0,0,0,0,0,0,0,0
"974",2017-09-04,0,0,0,0,0,0,0,0
"975",2017-09-05,0,0,0,0,0,0,0,0
"976",2017-09-06,14,27,40,628,0,25,2,736
"977",2017-09-07,12,21,36,500,0,14,2,585
"978",2017-09-08,14,30,31,399,0,17,2,493
"979",2017-09-09,0,0,0,0,0,0,0,0
"980",2017-09-10,0,0,0,0,0,0,0,0
"981",2017-09-11,9,34,38,546,0,22,2,651
"982",2017-09-12,13,22,34,474,0,17,1,561
"983",2017-09-13,9,36,37,477,0,21,2,582
"984",2017-09-14,8,24,32,406,0,19,2,491
"985",2017-09-15,10,28,23,355,0,10,2,428
"986",2017-09-16,0,0,0,0,0,0,0,0
"987",2017-09-17,0,0,0,0,0,6,0,6
"988",2017-09-18,3,36,32,1081,0,41,2,1195
"989",2017-09-19,5,28,25,1222,0,21,2,1303
"990",2017-09-20,7,32,29,1366,0,17,3,1454
"991",2017-09-21,4,25,29,2375,0,14,2,2449
"992",2017-09-22,16,22,30,2252,0,19,2,2341
"993",2017-09-23,2,13,19,2358,0,7,2,2401
"994",2017-09-24,2,12,21,2087,0,13,2,2137
"995",2017-09-25,10,41,51,6154,0,17,2,6275
"996",2017-09-26,13,45,59,5333,0,15,2,5467
"997",2017-09-27,12,36,46,4991,0,15,2,5102
"998",2017-09-28,17,37,53,4348,0,8,2,4465
"999",2017-09-29,15,35,33,3064,0,6,2,3155
"1000",2017-09-30,9,17,23,1378,0,3,2,1432
"1001",2017-10-01,4,27,24,1913,0,1,2,1971
"1002",2017-10-02,10,50,43,4952,0,6,2,5063
"1003",2017-10-03,13,37,57,4416,0,11,3,4537
"1004",2017-10-04,11,45,49,4289,0,11,3,4408
"1005",2017-10-05,7,31,50,3727,0,7,2,3824
"1006",2017-10-06,13,38,29,2526,0,5,2,2613
"1007",2017-10-07,3,22,19,1034,0,5,3,1086
"1008",2017-10-08,3,19,33,1534,0,0,2,1591
"1009",2017-10-09,9,50,62,4130,0,10,2,4263
"1010",2017-10-10,15,36,60,3733,0,9,2,3855
"1011",2017-10-11,14,37,60,3995,0,15,2,4123
"1012",2017-10-12,7,27,40,3452,0,8,2,3536
"1013",2017-10-13,15,41,43,2292,0,3,3,2397
"1014",2017-10-14,5,18,21,1413,0,3,2,1462
"1015",2017-10-15,2,31,21,1610,0,5,2,1671
"1016",2017-10-16,13,53,57,4071,0,6,2,4202
"1017",2017-10-17,17,35,53,3770,0,7,2,3884
"1018",2017-10-18,8,39,55,3851,0,6,2,3961
"1019",2017-10-19,7,39,44,3368,0,11,2,3471
"1020",2017-10-20,16,46,39,2361,0,5,2,2469
"1021",2017-10-21,4,29,27,1467,0,2,2,1531
"1022",2017-10-22,10,24,25,1594,0,3,2,1658
"1023",2017-10-23,10,44,46,4192,0,8,2,4302
"1024",2017-10-24,7,28,52,3768,0,10,2,3867
"1025",2017-10-25,14,46,62,3675,0,6,3,3806
"1026",2017-10-26,5,24,50,3316,0,9,2,3406
"1027",2017-10-27,12,35,42,2067,0,6,3,2165
"1028",2017-10-28,1,22,23,812,0,2,2,862
"1029",2017-10-29,7,25,29,1266,0,2,2,1331
"1030",2017-10-30,10,40,70,3708,0,9,4,3841
"1031",2017-10-31,13,44,57,3356,0,6,2,3478
"1032",2017-11-01,6,41,51,3483,0,7,2,3590
"1033",2017-11-02,10,40,60,3384,0,4,2,3500
"1034",2017-11-03,11,44,52,2214,0,2,4,2327
"1035",2017-11-04,13,28,32,1456,0,2,3,1534
"1036",2017-11-05,6,37,34,1492,0,1,2,1572
"1037",2017-11-06,9,56,73,4062,0,6,3,4209
"1038",2017-11-07,14,41,70,3844,0,7,2,3978
"1039",2017-11-08,18,49,66,3736,0,11,2,3882
"1040",2017-11-09,0,46,57,3411,0,7,2,3523
"1041",2017-11-10,17,48,50,2272,0,5,4,2396
"1042",2017-11-11,5,29,41,1763,0,2,3,1843
"1043",2017-11-12,5,30,29,1697,0,3,2,1766
"1044",2017-11-13,8,48,69,3911,0,11,2,4049
"1045",2017-11-14,18,49,72,3848,0,8,2,3997
"1046",2017-11-15,13,42,62,3649,0,10,3,3779
"1047",2017-11-16,12,44,55,3490,0,4,3,3608
"1048",2017-11-17,13,39,51,2311,0,0,2,2416
"1049",2017-11-18,7,26,32,1017,0,2,2,1086
"1050",2017-11-19,6,30,32,1373,0,1,2,1444
"1051",2017-11-20,15,50,57,3538,0,8,2,3670
"1052",2017-11-21,15,47,46,2839,0,7,2,2956
"1053",2017-11-22,12,27,35,1440,0,12,2,1528
"1054",2017-11-23,0,0,0,0,0,0,0,0
"1055",2017-11-24,0,0,0,0,0,0,0,0
"1056",2017-11-25,0,0,0,0,0,0,0,0
"1057",2017-11-26,9,26,30,1166,0,0,2,1233
"1058",2017-11-27,8,43,64,3651,0,7,2,3775
"1059",2017-11-28,10,55,63,3342,0,7,2,3479
"1060",2017-11-29,9,45,57,3362,0,10,2,3485
"1061",2017-11-30,10,39,52,3126,0,10,2,3239
"1062",2017-12-01,13,38,49,2208,0,8,2,2318
"1063",2017-12-02,9,31,40,1473,0,4,2,1559
"1064",2017-12-03,3,40,37,1641,0,3,2,1726
"1065",2017-12-04,8,42,73,2342,0,5,3,2473
"1066",2017-12-05,10,48,65,2068,0,8,2,2201
"1067",2017-12-06,16,48,64,1717,0,4,2,1851
"1068",2017-12-07,8,39,32,1111,0,6,3,1199
"1069",2017-12-08,11,50,39,827,0,6,2,935
"1070",2017-12-09,0,0,0,0,0,0,0,0
"1071",2017-12-10,0,0,0,0,0,0,0,0
"1072",2017-12-11,10,51,39,673,0,4,3,780
"1073",2017-12-12,9,38,40,624,0,5,2,718
"1074",2017-12-13,10,39,45,509,0,5,3,611
"1075",2017-12-14,13,31,51,467,0,7,2,571
"1076",2017-12-15,10,39,42,390,0,7,3,491
"1077",2017-12-16,0,0,0,0,0,0,0,0
"1078",2017-12-17,0,0,0,0,0,0,0,0
"1079",2017-12-18,10,57,51,461,0,6,2,587
"1080",2017-12-19,9,47,40,357,0,4,4,461
"1081",2017-12-20,10,36,40,331,0,6,2,425
"1082",2017-12-21,7,27,38,272,0,4,2,350
"1083",2017-12-22,16,33,26,223,0,2,2,302
"1084",2017-12-23,0,0,0,0,0,0,0,0
"1085",2017-12-24,0,0,0,0,0,0,0,0
"1086",2017-12-25,0,0,0,0,0,0,0,0
"1087",2017-12-26,5,32,35,195,0,2,3,272
"1088",2017-12-27,16,29,29,255,0,2,3,334
"1089",2017-12-28,11,28,29,248,0,2,4,322
"1090",2017-12-29,18,40,37,254,0,1,2,352
"1091",2017-12-30,0,0,0,0,0,0,0,0
"1092",2017-12-31,0,0,0,0,0,0,0,0
"1093",2018-01-01,0,0,0,0,0,0,0,0
"1094",2018-01-02,10,43,41,462,0,7,4,567
"1095",2018-01-03,15,45,40,482,0,6,4,592
"1096",2018-01-04,5,32,40,492,0,5,2,576
"1097",2018-01-05,15,37,41,569,0,7,2,671
"1098",2018-01-06,0,0,0,0,0,0,0,0
"1099",2018-01-07,2,21,13,899,0,1,0,936
"1100",2018-01-08,18,57,47,5326,0,15,3,5466
"1101",2018-01-09,9,57,39,5226,0,7,2,5340
"1102",2018-01-10,20,50,53,5105,0,14,4,5246
"1103",2018-01-11,11,48,48,4247,0,14,4,4372
"1104",2018-01-12,18,45,49,3044,0,6,4,3166
"1105",2018-01-13,4,27,26,1696,0,1,3,1757
"1106",2018-01-14,9,28,28,1915,0,2,3,1985
"1107",2018-01-15,12,54,47,2256,0,2,3,2374
"1108",2018-01-16,13,62,66,5126,0,12,3,5282
"1109",2018-01-17,16,53,66,5036,0,13,4,5188
"1110",2018-01-18,12,53,59,4155,0,10,3,4292
"1111",2018-01-19,27,50,56,3294,0,3,3,3433
"1112",2018-01-20,3,31,34,1827,0,2,3,1900
"1113",2018-01-21,1,40,42,1803,0,4,2,1892
"1114",2018-01-22,18,60,64,5253,0,15,5,5415
"1115",2018-01-23,15,48,64,4817,0,18,2,4964
"1116",2018-01-24,19,57,73,4796,0,14,6,4965
"1117",2018-01-25,12,49,62,4062,0,15,3,4203
"1118",2018-01-26,14,50,63,2946,0,8,4,3085
"1119",2018-01-27,10,32,35,1688,0,5,2,1772
"1120",2018-01-28,6,36,29,2191,0,5,4,2271
"1121",2018-01-29,18,56,63,4498,0,14,4,4653
"1122",2018-01-30,12,53,61,4492,0,15,2,4635
"1123",2018-01-31,11,56,60,4361,0,16,9,4513
"1124",2018-02-01,11,53,57,4039,0,16,3,4179
"1125",2018-02-02,11,38,51,2540,0,3,4,2647
"1126",2018-02-03,2,26,29,2063,0,7,2,2129
"1127",2018-02-04,3,33,32,1272,0,0,2,1342
"1128",2018-02-05,17,57,64,4538,0,14,5,4695
"1129",2018-02-06,11,47,62,4542,0,10,4,4676
"1130",2018-02-07,19,54,64,4666,0,15,5,4823
"1131",2018-02-08,15,42,49,3877,0,12,3,3998
"1132",2018-02-09,16,55,52,2533,0,4,4,2664
"1133",2018-02-10,4,37,25,1710,0,5,2,1783
"1134",2018-02-11,6,42,39,1992,0,5,2,2086
"1135",2018-02-12,14,64,71,4495,0,14,6,4664
"1136",2018-02-13,16,59,61,4277,0,12,3,4428
"1137",2018-02-14,15,52,47,3682,0,14,5,3815
"1138",2018-02-15,8,52,53,3720,0,11,3,3847
"1139",2018-02-16,15,50,50,2378,0,5,3,2501
"1140",2018-02-17,5,36,36,1523,0,3,2,1605
"1141",2018-02-18,9,32,43,1878,0,3,2,1967
"1142",2018-02-19,12,58,59,4178,0,15,7,4329
"1143",2018-02-20,7,52,57,4250,0,17,3,4386
"1144",2018-02-21,11,55,66,4341,0,15,9,4497
"1145",2018-02-22,7,50,53,3382,0,14,5,3511
"1146",2018-02-23,12,52,62,2485,0,6,4,2621
"1147",2018-02-24,5,31,27,1822,0,6,2,1893
"1148",2018-02-25,12,37,41,1991,0,5,2,2088
"1149",2018-02-26,16,68,76,4331,0,15,6,4512
"1150",2018-02-27,9,59,63,4361,0,19,4,4515
"1151",2018-02-28,12,57,70,4259,0,13,5,4416
"1152",2018-03-01,12,56,72,3797,0,17,3,3957
"1153",2018-03-02,9,47,50,2528,0,3,3,2640
"1154",2018-03-03,7,28,39,1538,0,2,2,1616
"1155",2018-03-04,8,34,28,1823,0,4,3,1900
"1156",2018-03-05,14,49,61,4267,0,12,5,4408
"1157",2018-03-06,8,44,59,4191,0,10,4,4316
"1158",2018-03-07,8,45,59,4233,0,10,5,4360
"1159",2018-03-08,9,38,48,3472,0,13,4,3584
"1160",2018-03-09,13,44,54,2492,0,3,4,2610
"1161",2018-03-10,6,29,40,1619,0,1,3,1698
"1162",2018-03-11,4,24,40,1601,0,3,2,1674
"1163",2018-03-12,13,43,45,3906,0,13,6,4026
"1164",2018-03-13,15,49,47,3542,0,15,2,3670
"1165",2018-03-14,13,57,56,3674,0,13,7,3820
"1166",2018-03-15,13,41,44,3366,0,16,5,3485
"1167",2018-03-16,15,47,54,2351,0,5,4,2476
"1168",2018-03-17,5,32,28,1447,0,1,3,1516
"1169",2018-03-18,4,31,32,1353,0,2,3,1425
"1170",2018-03-19,14,52,52,2129,0,3,2,2252
"1171",2018-03-20,16,40,51,1865,0,6,3,1981
"1172",2018-03-21,8,53,40,1598,0,3,2,1704
"1173",2018-03-22,13,33,33,985,0,5,3,1072
"1174",2018-03-23,11,36,31,652,0,3,3,736
"1175",2018-03-24,0,0,0,0,0,0,0,0
"1176",2018-03-25,0,0,0,0,0,0,0,0
"1177",2018-03-26,13,39,28,588,0,5,3,676
"1178",2018-03-27,11,29,19,480,0,6,2,547
"1179",2018-03-28,10,52,26,539,0,5,3,635
"1180",2018-03-29,10,33,20,453,0,2,3,521
"1181",2018-03-30,10,36,23,527,0,12,2,610
"1182",2018-03-31,0,0,0,0,0,0,0,0
"1183",2018-04-01,1,14,10,575,0,0,0,600
"1184",2018-04-02,19,49,43,4927,0,16,3,5057
"1185",2018-04-03,14,44,32,4841,0,11,0,4942
"1186",2018-04-04,11,46,46,4672,0,14,5,4794
"1187",2018-04-05,12,45,46,4247,0,15,1,4366
"1188",2018-04-06,22,58,39,2796,0,7,2,2924
"1189",2018-04-07,11,26,26,1678,0,7,0,1748
"1190",2018-04-08,10,40,31,2203,0,7,0,2291
"1191",2018-04-09,19,65,56,5077,0,18,1,5236
"1192",2018-04-10,15,57,43,4765,0,20,2,4902
"1193",2018-04-11,22,51,56,4498,0,15,3,4645
"1194",2018-04-12,14,42,35,3909,0,15,5,4020
"1195",2018-04-13,24,39,43,2750,0,8,1,2865
"1196",2018-04-14,5,26,29,1538,0,4,0,1602
"1197",2018-04-15,8,28,20,1583,0,4,0,1643
"1198",2018-04-16,17,57,48,4558,0,16,4,4700
"1199",2018-04-17,24,54,46,4193,0,9,3,4329
"1200",2018-04-18,12,46,50,4262,0,15,4,4389
"1201",2018-04-19,16,49,51,3577,0,13,3,3709
"1202",2018-04-20,20,39,27,2177,0,4,2,2269
"1203",2018-04-21,10,23,22,996,0,2,1,1054
"1204",2018-04-22,1,32,21,1434,0,0,0,1488
"1205",2018-04-23,10,55,43,4248,0,16,1,4373
"1206",2018-04-24,13,49,38,3931,0,9,1,4041
"1207",2018-04-25,13,45,46,3821,0,16,2,3943
"1208",2018-04-26,12,44,34,3443,0,10,1,3544
"1209",2018-04-27,9,33,32,2212,0,6,1,2293
"1210",2018-04-28,8,35,24,1456,0,3,0,1526
"1211",2018-04-29,6,26,31,1542,0,1,0,1606
"1212",2018-04-30,14,59,43,4233,0,17,1,4367
"1213",2018-05-01,14,45,44,3693,0,10,0,3806
"1214",2018-05-02,18,47,43,3874,0,12,2,3996
"1215",2018-05-03,12,30,44,3525,0,14,1,3626
"1216",2018-05-04,20,50,43,2212,0,8,2,2335
"1217",2018-05-05,3,27,25,1089,0,1,1,1146
"1218",2018-05-06,7,21,30,1452,0,4,0,1514
"1219",2018-05-07,11,65,45,4020,0,17,0,4158
"1220",2018-05-08,9,53,57,3872,0,7,0,3998
"1221",2018-05-09,10,56,52,3912,0,11,1,4042
"1222",2018-05-10,7,52,51,3520,0,11,1,3642
"1223",2018-05-11,11,41,38,2155,0,4,1,2250
"1224",2018-05-12,7,24,24,1332,0,3,0,1390
"1225",2018-05-13,1,20,16,1227,0,2,0,1266
"1226",2018-05-14,10,51,50,3936,0,15,1,4063
"1227",2018-05-15,12,61,50,3735,0,13,0,3871
"1228",2018-05-16,9,45,41,3685,0,17,3,3800
"1229",2018-05-17,8,60,39,3104,0,8,0,3219
"1230",2018-05-18,9,28,39,1913,0,5,2,1996
"1231",2018-05-19,3,22,27,1086,0,1,0,1139
"1232",2018-05-20,3,25,20,1303,0,2,1,1354
"1233",2018-05-21,12,59,49,3942,0,12,0,4074
"1234",2018-05-22,9,43,41,3526,0,12,2,3633
"1235",2018-05-23,10,35,46,3495,0,14,2,3602
"1236",2018-05-24,4,42,41,3072,0,6,1,3166
"1237",2018-05-25,9,32,31,1869,0,3,4,1948
"1238",2018-05-26,2,17,23,1038,0,2,0,1082
"1239",2018-05-27,3,17,20,970,0,2,1,1013
"1240",2018-05-28,9,28,23,946,0,3,0,1009
"1241",2018-05-29,7,35,42,3344,0,14,0,3442
"1242",2018-05-30,5,49,50,3666,0,13,2,3785
"1243",2018-05-31,11,32,44,3051,0,10,1,3149
"1244",2018-06-01,14,40,29,2079,0,4,1,2167
"1245",2018-06-02,4,27,30,1170,0,0,0,1231
"1246",2018-06-03,7,29,20,1440,0,2,1,1499
"1247",2018-06-04,8,52,47,3485,0,12,0,3604
"1248",2018-06-05,5,42,49,3262,0,10,0,3368
"1249",2018-06-06,10,36,39,3208,0,12,1,3306
"1250",2018-06-07,10,44,44,2949,0,7,1,3055
"1251",2018-06-08,13,30,28,1662,0,6,1,1740
"1252",2018-06-09,7,23,22,1136,0,3,0,1191
"1253",2018-06-10,6,20,17,1041,0,1,0,1085
"1254",2018-06-11,18,54,46,1637,0,4,0,1759
"1255",2018-06-12,12,39,35,1518,0,6,0,1610
"1256",2018-06-13,16,43,29,1313,0,7,0,1408
"1257",2018-06-14,12,22,28,816,0,3,0,881
"1258",2018-06-15,5,22,26,609,0,3,0,665
"1259",2018-06-16,4,17,10,347,0,0,1,379
"1260",2018-06-17,2,16,15,277,0,1,1,312
"1261",2018-06-18,8,26,29,314,0,1,0,378
"1262",2018-06-19,11,37,30,484,0,5,0,567
"1263",2018-06-20,12,29,36,473,0,6,0,556
"1264",2018-06-21,11,17,21,432,0,4,1,486
"1265",2018-06-22,12,31,36,414,0,4,0,497
"1266",2018-06-23,0,0,0,0,0,0,0,0
"1267",2018-06-24,0,0,0,0,0,0,0,0
"1268",2018-06-25,21,21,20,746,0,33,0,841
"1269",2018-06-26,19,34,29,787,0,21,0,890
"1270",2018-06-27,13,23,28,725,0,19,1,809
"1271",2018-06-28,16,29,24,682,0,30,1,782
"1272",2018-06-29,21,26,30,585,0,23,0,685
"1273",2018-06-30,9,7,18,237,0,8,3,282
"1274",2018-07-01,4,11,7,262,0,5,0,289
"1275",2018-07-02,22,32,34,702,0,24,0,814
"1276",2018-07-03,17,29,43,718,0,30,2,839
"1277",2018-07-04,0,0,0,0,0,0,0,0
"1278",2018-07-05,23,31,29,612,0,30,1,726
"1279",2018-07-06,13,32,33,583,0,16,0,677
"1280",2018-07-07,7,18,18,271,0,7,3,324
"1281",2018-07-08,5,10,13,270,0,14,0,312
"1282",2018-07-09,22,30,41,757,0,32,0,882
"1283",2018-07-10,23,30,42,755,0,16,1,867
"1284",2018-07-11,14,28,45,677,0,23,0,787
"1285",2018-07-12,15,20,25,653,0,28,1,742
"1286",2018-07-13,17,25,31,509,0,25,0,607
"1287",2018-07-14,5,10,20,252,0,5,1,293
"1288",2018-07-15,5,14,12,259,0,17,1,308
"1289",2018-07-16,21,37,31,681,0,19,0,789
"1290",2018-07-17,23,38,36,703,0,16,1,817
"1291",2018-07-18,14,34,29,662,0,22,0,761
"1292",2018-07-19,12,36,30,528,0,30,0,636
"1293",2018-07-20,16,28,42,474,0,21,0,581
"1294",2018-07-21,5,12,15,234,0,6,2,274
"1295",2018-07-22,2,12,19,227,0,4,1,265
"1296",2018-07-23,17,34,39,642,0,21,2,755
"1297",2018-07-24,10,26,34,621,0,22,0,713
"1298",2018-07-25,14,27,29,620,0,35,0,725
"1299",2018-07-26,13,25,30,576,0,14,1,659
"1300",2018-07-27,13,32,35,554,0,16,0,650
"1301",2018-07-28,6,13,25,270,0,5,2,321
"1302",2018-07-29,2,17,13,239,0,6,0,277
"1303",2018-07-30,14,48,48,751,0,27,0,888
"1304",2018-07-31,19,43,51,764,0,26,1,904
"1305",2018-08-01,13,52,49,673,0,24,2,813
"1306",2018-08-02,18,42,40,661,0,30,0,791
"1307",2018-08-03,20,44,41,559,0,22,0,686
"1308",2018-08-04,7,19,25,317,0,9,3,380
"1309",2018-08-05,3,16,30,296,0,9,1,355
"1310",2018-08-06,10,56,40,717,0,29,1,853
"1311",2018-08-07,16,36,59,705,0,24,1,841
"1312",2018-08-08,16,61,34,693,0,26,0,830
"1313",2018-08-09,11,35,41,635,0,29,3,754
"1314",2018-08-10,13,45,39,589,0,18,0,704
"1315",2018-08-11,4,13,19,303,0,17,0,356
"1316",2018-08-12,3,16,20,268,0,12,1,320
"1317",2018-08-13,17,56,41,614,0,27,1,756
"1318",2018-08-14,11,41,39,605,0,22,1,719
"1319",2018-08-15,16,45,46,541,0,34,1,683
"1320",2018-08-16,11,43,42,457,0,23,1,577
"1321",2018-08-17,10,36,33,441,0,17,0,537
"1322",2018-08-18,1,17,19,229,0,7,2,275
"1323",2018-08-19,8,17,22,227,0,7,0,281
"1324",2018-08-20,9,47,42,582,0,18,1,699
"1325",2018-08-21,15,31,41,508,0,20,0,615
"1326",2018-08-22,10,42,46,499,0,23,1,621
"1327",2018-08-23,10,36,40,453,0,24,0,563
"1328",2018-08-24,11,42,36,471,0,29,0,589
"1329",2018-08-25,0,0,0,0,0,0,0,0
"1330",2018-08-26,0,0,0,0,0,0,0,0
"1331",2018-08-27,0,2,2,3,0,0,0,7
"1332",2018-08-28,0,0,0,0,0,0,0,0
"1333",2018-08-29,1,1,0,5,0,0,2,9
"1334",2018-08-30,0,0,0,0,0,0,0,0
"1335",2018-08-31,1,0,0,11,0,24,2,38
"1336",2018-09-01,0,0,0,0,0,0,0,0
"1337",2018-09-02,0,0,0,0,0,0,0,0
"1338",2018-09-03,0,0,0,0,0,0,0,0
"1339",2018-09-04,0,0,0,0,0,0,0,0
"1340",2018-09-05,1,2,0,8,0,2,2,15
"1341",2018-09-06,0,0,0,0,0,0,0,0
"1342",2018-09-07,0,0,0,0,0,5,0,5
"1343",2018-09-08,0,0,0,0,0,0,0,0
"1344",2018-09-09,0,0,0,0,0,0,0,0
"1345",2018-09-10,17,33,0,464,0,27,32,573
"1346",2018-09-11,16,32,0,414,0,10,35,507
"1347",2018-09-12,19,25,0,347,0,13,38,442
"1348",2018-09-13,11,30,0,338,0,13,33,425
"1349",2018-09-14,11,25,0,335,0,17,34,422
"1350",2018-09-15,0,0,0,0,0,0,0,0
"1351",2018-09-16,0,0,0,0,0,0,0,0
"1352",2018-09-17,14,32,0,1053,0,38,41,1178
"1353",2018-09-18,7,34,0,1028,0,25,43,1137
"1354",2018-09-19,8,28,0,1232,0,22,47,1337
"1355",2018-09-20,6,26,0,2850,0,14,45,2941
"1356",2018-09-21,7,34,0,2012,0,10,64,2127
"1357",2018-09-22,0,9,0,1192,0,9,30,1240
"1358",2018-09-23,2,9,0,1922,0,6,34,1973
"1359",2018-09-24,11,42,0,5680,0,26,177,5936
"1360",2018-09-25,9,38,0,4883,0,19,151,5100
"1361",2018-09-26,10,44,0,4637,0,9,181,4881
"1362",2018-09-27,7,33,0,4116,0,10,131,4297
"1363",2018-09-28,9,35,0,2710,0,5,134,2893
"1364",2018-09-29,4,18,0,1706,0,0,69,1797
"1365",2018-09-30,5,18,0,1706,0,3,68,1800
"1366",2018-10-01,14,42,0,4906,0,12,213,5187
"1367",2018-10-02,14,38,0,4609,0,18,199,4878
"1368",2018-10-03,8,39,0,4237,0,8,173,4465
"1369",2018-10-04,12,29,0,3538,0,12,156,3747
"1370",2018-10-05,11,32,0,2224,0,4,164,2435
"1371",2018-10-06,4,17,0,1527,0,2,73,1623
"1372",2018-10-07,2,20,0,1404,0,0,60,1486
"1373",2018-10-08,17,53,0,3861,0,11,224,4166
"1374",2018-10-09,11,46,0,3776,0,14,182,4029
"1375",2018-10-10,15,39,0,3701,0,3,203,3961
"1376",2018-10-11,13,31,0,3366,0,8,170,3588
"1377",2018-10-12,13,32,0,2163,0,6,151,2365
"1378",2018-10-13,6,19,0,725,0,1,53,804
"1379",2018-10-14,4,16,0,1292,0,2,62,1376
"1380",2018-10-15,10,48,0,3869,0,11,205,4143
"1381",2018-10-16,18,42,0,3613,0,12,188,3873
"1382",2018-10-17,16,47,0,3646,0,6,210,3925
"1383",2018-10-18,10,41,0,3006,0,9,154,3220
"1384",2018-10-19,10,41,0,2580,0,8,160,2799
"1385",2018-10-20,1,18,0,1295,0,0,66,1380
"1386",2018-10-21,5,24,0,1461,0,1,57,1548
"1387",2018-10-22,12,40,0,3932,0,14,220,4218
"1388",2018-10-23,16,42,0,3598,0,11,202,3869
"1389",2018-10-24,7,48,0,3507,0,10,205,3777
"1390",2018-10-25,9,39,0,3023,0,10,143,3224
"1391",2018-10-26,16,41,0,2024,0,7,175,2263
"1392",2018-10-27,3,22,0,1142,0,1,63,1231
"1393",2018-10-28,5,21,0,1194,0,6,76,1302
"1394",2018-10-29,11,54,0,3548,0,12,210,3835
"1395",2018-10-30,16,42,0,3448,0,17,198,3721
"1396",2018-10-31,9,39,0,3231,0,12,205,3496
"1397",2018-11-01,11,42,0,2838,0,19,186,3096
"1398",2018-11-02,14,46,0,2225,0,8,169,2462
"1399",2018-11-03,6,19,0,850,0,0,77,952
"1400",2018-11-04,3,21,0,1486,0,3,82,1595
"1401",2018-11-05,9,46,0,3765,0,12,228,4060
"1402",2018-11-06,14,47,0,3451,0,14,210,3736
"1403",2018-11-07,13,52,0,3535,0,4,191,3795
"1404",2018-11-08,9,32,0,3171,0,8,175,3395
"1405",2018-11-09,10,38,0,2097,0,8,164,2317
"1406",2018-11-10,7,15,0,1293,0,3,74,1392
"1407",2018-11-11,0,24,0,1412,0,5,76,1517
"1408",2018-11-12,8,46,0,3794,0,11,222,4081
"1409",2018-11-13,19,52,0,3319,0,10,224,3624
"1410",2018-11-14,8,45,0,3453,0,11,174,3691
"1411",2018-11-15,11,40,0,2957,0,7,173,3188
"1412",2018-11-16,14,44,0,2199,0,1,155,2413
"1413",2018-11-17,5,36,0,1089,0,3,75,1208
"1414",2018-11-18,5,28,0,1315,0,0,64,1412
"1415",2018-11-19,13,48,0,3304,0,5,198,3568
"1416",2018-11-20,14,41,0,2482,0,8,178,2723
"1417",2018-11-21,19,43,0,1442,0,6,144,1654
"1418",2018-11-22,0,0,0,0,0,0,0,0
"1419",2018-11-23,0,0,0,0,0,0,0,0
"1420",2018-11-24,0,0,0,0,0,0,0,0
"1421",2018-11-25,8,29,0,967,0,1,81,1086
"1422",2018-11-26,8,51,0,3385,0,7,198,3649
"1423",2018-11-27,19,48,0,3106,0,9,202,3384
"1424",2018-11-28,11,48,0,3101,0,9,188,3357
"1425",2018-11-29,13,40,0,2841,0,3,183,3080
"1426",2018-11-30,16,31,0,2018,0,2,158,2225
"1427",2018-12-01,10,28,0,1357,0,4,72,1471
"1428",2018-12-02,3,25,0,1234,0,2,67,1331
"1429",2018-12-03,12,47,0,1765,0,5,192,2021
"1430",2018-12-04,10,50,0,1631,0,9,195,1895
"1431",2018-12-05,12,54,0,1532,0,6,169,1773
"1432",2018-12-06,7,34,0,959,0,9,159,1168
"1433",2018-12-07,17,36,0,777,0,19,149,998
"1434",2018-12-08,0,0,0,0,0,0,0,0
"1435",2018-12-09,0,0,0,0,0,0,0,0
"1436",2018-12-10,13,51,0,627,0,5,166,862
"1437",2018-12-11,10,49,0,556,0,5,181,801
"1438",2018-12-12,9,31,0,469,0,4,146,659
"1439",2018-12-13,17,33,0,421,0,5,131,607
"1440",2018-12-14,12,32,0,389,0,8,144,585
"1441",2018-12-15,0,0,0,0,0,0,0,0
"1442",2018-12-16,0,0,0,0,0,0,0,0
"1443",2018-12-17,9,41,0,432,0,4,162,648
"1444",2018-12-18,15,34,0,368,0,5,126,548
"1445",2018-12-19,10,26,0,327,0,7,150,520
"1446",2018-12-20,13,32,0,279,0,4,123,451
"1447",2018-12-21,15,39,0,263,0,4,112,433
"1448",2018-12-22,0,0,0,0,0,0,0,0
"1449",2018-12-23,0,0,0,0,0,0,0,0
"1450",2018-12-24,0,0,0,0,0,0,0,0
"1451",2018-12-25,0,0,0,0,0,0,0,0
"1452",2018-12-26,8,24,0,171,0,1,93,297
"1453",2018-12-27,8,23,0,239,0,4,89,363
"1454",2018-12-28,8,26,0,238,0,4,116,392
"1455",2018-12-29,0,0,0,0,0,0,0,0
"1456",2018-12-30,0,0,0,0,0,0,0,0
"1457",2018-12-31,0,0,0,0,0,0,0,0
"1458",2019-01-01,0,0,0,0,0,0,0,0
"1459",2019-01-02,9,34,0,360,0,9,149,561
"1460",2019-01-03,7,34,0,475,0,2,118,636
"1461",2019-01-04,8,45,0,546,0,13,146,758
"1462",2019-01-05,0,0,0,0,0,0,0,0
"1463",2019-01-06,1,5,0,529,0,0,16,551
"1464",2019-01-07,13,42,0,3858,0,15,221,4149
"1465",2019-01-08,15,49,0,4783,0,19,228,5094
"1466",2019-01-09,21,34,0,4703,0,10,253,5021
"1467",2019-01-10,19,41,0,3974,0,14,229,4277
"1468",2019-01-11,26,38,0,2880,0,10,214,3168
"1469",2019-01-12,3,25,0,1837,0,3,90,1958
"1470",2019-01-13,7,28,0,1851,0,1,88,1975
"1471",2019-01-14,17,52,0,5010,0,16,270,5365
"1472",2019-01-15,17,54,0,4660,0,13,236,4980
"1473",2019-01-16,16,59,0,4540,0,13,252,4880
"1474",2019-01-17,13,34,0,3976,0,14,265,4302
"1475",2019-01-18,23,35,0,2385,0,5,194,2642
"1476",2019-01-19,8,27,0,1586,0,4,97,1722
"1477",2019-01-20,12,27,0,1348,0,1,92,1480
"1478",2019-01-21,11,37,0,1795,0,3,134,1980
"1479",2019-01-22,18,47,0,4363,0,18,286,4732
"1480",2019-01-23,12,51,0,4699,0,9,267,5038
"1481",2019-01-24,16,47,0,3816,0,15,259,4153
"1482",2019-01-25,22,43,0,2835,0,17,194,3111
"1483",2019-01-26,6,30,0,1743,0,0,88,1867
"1484",2019-01-27,8,29,0,1975,0,1,116,2129
"1485",2019-01-28,16,50,0,4427,0,13,293,4799
"1486",2019-01-29,16,46,0,4034,0,17,271,4384
"1487",2019-01-30,22,38,0,4217,0,11,262,4550
"1488",2019-01-31,17,43,0,3649,0,11,230,3950
"1489",2019-02-01,24,32,0,2556,0,6,184,2802
"1490",2019-02-02,4,28,0,1867,0,5,118,2022
"1491",2019-02-03,8,30,0,1315,0,1,88,1442
"1492",2019-02-04,19,40,0,4305,0,13,249,4626
"1493",2019-02-05,18,43,0,3971,0,21,237,4290
"1494",2019-02-06,12,46,0,4119,0,12,247,4436
"1495",2019-02-07,9,37,0,3683,0,14,234,3977
"1496",2019-02-08,11,37,0,2348,0,9,207,2612
"1497",2019-02-09,4,22,0,1683,0,0,102,1811
"1498",2019-02-10,12,41,0,1942,0,1,109,2105
"1499",2019-02-11,14,57,0,4283,0,17,300,4671
"1500",2019-02-12,24,45,0,3806,0,15,255,4145
"1501",2019-02-13,16,41,0,3960,0,8,260,4285
"1502",2019-02-14,11,37,0,3190,0,8,225,3471
"1503",2019-02-15,19,35,0,2112,0,3,205,2374
"1504",2019-02-16,11,23,0,1415,0,2,106,1557
"1505",2019-02-17,8,25,0,1740,0,4,76,1853
"1506",2019-02-18,14,47,0,4242,0,13,258,4574
"1507",2019-02-19,18,48,0,3852,0,14,241,4173
"1508",2019-02-20,17,47,0,3902,0,8,259,4233
"1509",2019-02-21,19,44,0,3568,0,11,220,3862
"1510",2019-02-22,15,27,0,2369,0,9,186,2606
"1511",2019-02-23,5,28,0,1673,0,1,106,1813
"1512",2019-02-24,11,26,0,1932,0,11,111,2091
"1513",2019-02-25,0,0,0,0,0,0,0,0
"1514",2019-02-26,6,15,0,2055,0,3,99,2178
"1515",2019-02-27,0,0,0,0,0,0,0,0
"1516",2019-02-28,10,25,0,3591,0,17,193,3836
"1517",2019-03-01,9,25,0,2744,0,12,147,2937
"1518",2019-03-02,10,14,0,1694,0,3,119,1840
"1519",2019-03-03,9,29,0,1821,0,2,107,1968
"1520",2019-03-04,11,42,0,3865,0,9,256,4183
"1521",2019-03-05,13,46,0,3569,0,17,266,3911
"1522",2019-03-06,14,50,0,3815,0,13,222,4114
"1523",2019-03-07,26,52,0,3716,0,23,283,4100
"1524",2019-03-08,17,39,0,2581,0,11,189,2837
"1525",2019-03-09,5,29,0,1549,0,5,108,1696
"1526",2019-03-10,5,35,0,1693,0,2,118,1853
"1527",2019-03-11,13,48,0,3817,0,15,256,4149
"1528",2019-03-12,19,53,0,3643,0,20,260,3995
"1529",2019-03-13,15,46,0,3788,0,21,252,4122
"1530",2019-03-14,15,38,0,3377,0,13,239,3682
"1531",2019-03-15,22,26,0,2280,0,6,198,2532
"1532",2019-03-16,5,23,0,1486,0,4,94,1612
"1533",2019-03-17,10,17,0,1435,0,3,107,1572
"1534",2019-03-18,13,43,0,2098,0,9,223,2386
"1535",2019-03-19,21,44,0,1916,0,10,205,2196
"1536",2019-03-20,17,38,0,1549,0,13,184,1801
"1537",2019-03-21,10,28,0,985,0,4,177,1204
"1538",2019-03-22,12,42,0,693,0,5,163,915
"1539",2019-03-23,0,0,0,0,0,0,0,0
"1540",2019-03-24,0,0,0,0,0,0,0,0
"1541",2019-03-25,13,50,0,526,0,5,184,778
"1542",2019-03-26,6,36,0,488,0,6,147,683
"1543",2019-03-27,9,44,0,522,0,3,141,719
"1544",2019-03-28,25,32,0,456,0,6,146,665
"1545",2019-03-29,8,41,0,494,0,3,128,674
"1546",2019-03-30,0,0,0,0,0,0,0,0
"1547",2019-03-31,4,7,0,642,0,0,30,683
"1548",2019-04-01,17,59,0,5142,0,22,239,5479
"1549",2019-04-02,26,47,0,5028,0,20,259,5380
"1550",2019-04-03,18,54,0,5010,0,13,283,5378
"1551",2019-04-04,19,45,0,4017,0,23,217,4321
"1552",2019-04-05,17,44,0,2874,0,12,230,3177
"1553",2019-04-06,6,23,0,1829,0,1,104,1963
"1554",2019-04-07,13,24,0,2042,0,1,110,2190
"1555",2019-04-08,17,62,0,5212,0,17,297,5605
"1556",2019-04-09,26,59,0,4867,0,20,303,5275
"1557",2019-04-10,19,60,0,5075,0,14,300,5468
"1558",2019-04-11,18,49,0,4376,0,15,287,4745
"1559",2019-04-12,19,48,0,2643,0,6,218,2934
"1560",2019-04-13,5,31,0,1619,0,11,101,1767
"1561",2019-04-14,11,27,0,1738,0,1,104,1881
"1562",2019-04-15,21,68,0,4794,0,13,276,5172
"1563",2019-04-16,28,60,0,4702,0,18,315,5123
"1564",2019-04-17,14,63,0,4640,0,18,286,5021
"1565",2019-04-18,14,49,0,3730,0,16,214,4023
"1566",2019-04-19,15,41,0,2424,0,10,225,2715
"1567",2019-04-20,11,24,0,956,0,2,110,1103
"1568",2019-04-21,6,33,0,1294,0,1,70,1404
"1569",2019-04-22,17,60,0,4499,0,18,277,4871
"1570",2019-04-23,17,59,0,4541,0,26,282,4925
"1571",2019-04-24,19,60,0,4655,0,17,278,5029
"1572",2019-04-25,21,53,0,3695,0,18,252,4039
"1573",2019-04-26,19,45,0,2332,0,6,186,2588
"1574",2019-04-27,3,29,0,1551,0,0,111,1694
"1575",2019-04-28,9,21,0,1571,0,2,106,1709
"1576",2019-04-29,19,50,0,4354,0,19,278,4720
"1577",2019-04-30,27,56,0,4128,0,15,257,4483
"1578",2019-05-01,17,48,0,4211,0,15,279,4570
"1579",2019-05-02,16,49,0,3756,0,19,248,4088
"1580",2019-05-03,10,35,0,2108,0,6,193,2352
"1581",2019-05-04,11,29,0,1354,0,0,99,1493
"1582",2019-05-05,11,20,0,1375,0,1,92,1499
"1583",2019-05-06,18,52,0,4269,0,14,316,4669
"1584",2019-05-07,12,57,0,4243,0,23,302,4637
"1585",2019-05-08,22,58,0,4130,0,15,267,4492
"1586",2019-05-09,18,35,0,3520,0,15,260,3848
"1587",2019-05-10,16,51,0,2218,0,10,199,2494
"1588",2019-05-11,4,24,0,1168,0,0,91,1287
"1589",2019-05-12,11,25,0,1265,0,1,87,1389
"1590",2019-05-13,19,61,0,3977,0,17,295,4369
"1591",2019-05-14,25,53,0,3979,0,15,297,4369
"1592",2019-05-15,18,53,0,4100,0,21,284,4476
"1593",2019-05-16,12,47,0,3486,0,13,258,3816
"1594",2019-05-17,22,39,0,2348,0,7,207,2623
"1595",2019-05-18,7,20,0,1463,0,1,109,1600
"1596",2019-05-19,8,32,0,1588,0,2,109,1739
"1597",2019-05-20,19,68,0,4009,0,18,258,4372
"1598",2019-05-21,22,49,0,3929,0,20,272,4292
"1599",2019-05-22,17,43,0,4121,0,14,261,4456
"1600",2019-05-23,15,46,0,3251,0,18,253,3583
"1601",2019-05-24,10,30,0,2043,0,6,198,2287
"1602",2019-05-25,5,31,0,1109,0,1,91,1237
"1603",2019-05-26,10,26,0,1018,0,2,96,1152
"1604",2019-05-27,3,28,0,1250,0,0,119,1400
"1605",2019-05-28,11,41,0,3851,0,15,277,4195
"1606",2019-05-29,15,44,0,3999,0,20,232,4310
"1607",2019-05-30,11,43,0,3462,0,14,246,3776
"1608",2019-05-31,11,31,0,2244,0,6,190,2482
"1609",2019-06-01,10,22,0,1216,0,0,93,1341
"1610",2019-06-02,6,27,0,1460,0,3,85,1581
"1611",2019-06-03,11,48,0,3845,0,13,262,4179
"1612",2019-06-04,16,46,0,3528,0,16,266,3872
"1613",2019-06-05,10,43,0,3377,0,16,226,3672
"1614",2019-06-06,15,39,0,3318,0,11,231,3614
"1615",2019-06-07,15,34,0,2017,0,2,170,2238
"1616",2019-06-08,1,27,0,1329,0,1,100,1458
"1617",2019-06-09,5,25,0,1219,0,0,90,1339
"1618",2019-06-10,19,43,0,1895,0,8,224,2189
"1619",2019-06-11,18,37,0,1747,0,8,213,2023
"1620",2019-06-12,21,40,0,1377,0,1,210,1649
"1621",2019-06-13,16,32,0,894,0,4,189,1135
"1622",2019-06-14,11,33,0,749,0,3,159,955
"1623",2019-06-15,3,7,0,299,0,0,55,364
"1624",2019-06-16,2,16,0,270,0,0,51,339
"1625",2019-06-17,10,20,0,337,0,3,147,517
"1626",2019-06-18,9,24,0,473,0,4,167,677
"1627",2019-06-19,10,22,0,449,0,4,129,614
"1628",2019-06-20,18,27,0,478,0,4,150,677
"1629",2019-06-21,14,30,0,417,0,3,117,581
"1630",2019-06-22,0,0,0,0,0,0,0,0
"1631",2019-06-23,0,0,0,0,0,0,0,0
"1632",2019-06-24,22,30,0,630,0,4,297,983
"1633",2019-06-25,23,32,0,607,0,19,299,980
"1634",2019-06-26,26,33,0,625,0,12,303,999
"1635",2019-06-27,27,29,0,537,0,18,283,894
"1636",2019-06-28,15,25,0,510,0,8,234,792
"1637",2019-06-29,12,12,0,236,0,3,92,355
"1638",2019-06-30,8,12,0,204,0,3,104,331
"1639",2019-07-01,19,37,0,593,0,14,340,1003
"1640",2019-07-02,12,33,0,544,0,24,349,962
"1641",2019-07-03,13,28,0,564,0,17,316,938
"1642",2019-07-04,0,0,0,0,0,0,0,0
"1643",2019-07-05,12,34,0,376,0,6,227,655
"1644",2019-07-06,10,21,0,249,0,8,144,432
"1645",2019-07-07,14,19,0,236,0,13,147,429
"1646",2019-07-08,18,36,0,594,0,11,366,1025
"1647",2019-07-09,13,33,0,580,0,15,375,1016
"1648",2019-07-10,12,37,0,620,0,21,333,1023
"1649",2019-07-11,19,27,0,565,0,10,341,962
"1650",2019-07-12,14,35,0,508,0,6,275,838
"1651",2019-07-13,7,18,0,208,0,6,106,345
"1652",2019-07-14,9,24,0,237,0,1,116,387
"1653",2019-07-15,17,39,0,604,0,12,338,1010
"1654",2019-07-16,9,36,0,587,0,28,393,1053
"1655",2019-07-17,9,41,0,543,0,20,344,957
"1656",2019-07-18,23,32,0,473,0,19,325,872
"1657",2019-07-19,6,45,0,468,0,9,273,801
"1658",2019-07-20,2,21,0,195,0,5,119,342
"1659",2019-07-21,7,19,0,199,0,6,111,342
"1660",2019-07-22,6,47,0,564,0,15,402,1034
"1661",2019-07-23,13,39,0,556,0,20,371,999
"1662",2019-07-24,17,36,0,533,0,15,347,948
"1663",2019-07-25,8,42,0,452,0,14,331,847
"1664",2019-07-26,10,31,0,370,0,15,323,749
"1665",2019-07-27,2,19,0,194,0,4,110,329
"1666",2019-07-28,6,13,0,200,0,6,116,341
"1667",2019-07-29,13,44,0,566,0,20,391,1034
"1668",2019-07-30,16,33,0,510,0,19,382,960
"1669",2019-07-31,11,35,0,469,0,16,355,886
"1670",2019-08-01,12,37,0,444,0,16,356,865
"1671",2019-08-02,10,41,0,400,0,8,318,777
"1672",2019-08-03,3,13,0,206,0,9,120,351
"1673",2019-08-04,4,20,0,220,0,8,121,373
"1674",2019-08-05,9,43,0,484,0,19,412,967
"1675",2019-08-06,12,41,0,468,0,13,368,902
"1676",2019-08-07,11,42,0,464,0,14,346,877
"1677",2019-08-08,10,33,0,428,0,12,292,775
"1678",2019-08-09,11,42,0,340,0,8,295,696
"1679",2019-08-10,1,15,0,208,0,6,115,345
"1680",2019-08-11,5,20,0,200,0,3,147,375
"1681",2019-08-12,13,42,0,458,0,16,387,916
"1682",2019-08-13,10,34,0,396,0,11,341,792
"1683",2019-08-14,10,39,0,396,0,14,343,802
"1684",2019-08-15,16,34,0,328,0,9,321,708
"1685",2019-08-16,7,28,0,339,0,10,294,678
"1686",2019-08-17,0,16,0,151,0,5,115,287
"1687",2019-08-18,0,20,0,173,0,5,128,326
"1688",2019-08-19,14,35,0,340,0,18,318,725
"1689",2019-08-20,16,43,0,381,0,13,342,795
"1690",2019-08-21,9,40,0,314,0,19,305,687
"1691",2019-08-22,16,35,0,305,0,13,287,656
"1692",2019-08-23,7,43,0,302,0,9,274,635
"1693",2019-08-24,0,0,0,0,0,0,0,0
"1694",2019-08-25,0,0,0,0,0,0,0,0
"1695",2019-08-26,0,0,0,0,0,0,0,0
"1696",2019-08-27,0,0,0,0,0,0,0,0
"1697",2019-08-28,0,0,0,0,0,0,0,0
"1698",2019-08-29,0,0,0,0,0,0,0,0
"1699",2019-08-30,0,0,0,0,0,0,0,0
"1700",2019-08-31,0,0,0,0,0,0,0,0
"1701",2019-09-01,0,0,0,0,0,0,0,0
"1702",2019-09-02,0,0,0,0,0,0,0,0
"1703",2019-09-03,0,0,0,0,0,9,0,9
"1704",2019-09-04,0,0,0,0,0,0,0,0
"1705",2019-09-05,0,0,0,0,0,1,0,1
"1706",2019-09-06,0,0,0,0,0,4,0,4
"1707",2019-09-07,0,0,0,0,0,0,0,0
"1708",2019-09-08,0,0,0,0,0,0,0,0
"1709",2019-09-09,11,46,0,331,0,13,313,714
"1710",2019-09-10,13,28,0,332,0,7,283,663
"1711",2019-09-11,11,39,0,306,0,14,268,638
"1712",2019-09-12,10,25,0,287,0,18,245,585
"1713",2019-09-13,10,33,0,213,0,6,198,460
"1714",2019-09-14,0,0,0,0,0,0,0,0
"1715",2019-09-15,0,0,0,0,0,0,0,0
"1716",2019-09-16,14,40,0,628,0,10,279,971
"1717",2019-09-17,11,43,0,620,0,15,312,1001
"1718",2019-09-18,14,29,0,685,0,23,238,989
"1719",2019-09-19,10,34,0,669,0,23,240,976
"1720",2019-09-20,10,37,0,700,0,18,237,1002
"1721",2019-09-21,0,0,0,0,0,0,0,0
"1722",2019-09-22,0,0,0,0,0,0,0,0
"1723",2019-09-23,20,43,0,1542,0,25,331,1961
"1724",2019-09-24,14,31,0,1358,0,26,296,1725
"1725",2019-09-25,8,36,0,1371,0,10,250,1675
"1726",2019-09-26,5,26,0,1442,0,18,255,1746
"1727",2019-09-27,7,38,0,1358,0,6,199,1608
"1728",2019-09-28,6,18,0,1794,0,6,117,1941
"1729",2019-09-29,3,7,0,2269,0,3,90,2372
"1730",2019-09-30,15,42,0,4232,0,17,281,4587
"1731",2019-10-01,22,50,0,5348,0,15,288,5723
"1732",2019-10-02,21,45,0,4962,0,22,295,5345
"1733",2019-10-03,18,34,0,4257,0,14,279,4602
"1734",2019-10-04,13,51,0,3110,0,10,223,3407
"1735",2019-10-05,6,23,0,1253,0,2,58,1342
"1736",2019-10-06,9,29,0,1782,0,1,71,1892
"1737",2019-10-07,16,51,0,4883,0,21,300,5271
"1738",2019-10-08,27,45,0,4365,0,8,301,4746
"1739",2019-10-09,18,53,0,4336,0,14,278,4699
"1740",2019-10-10,13,46,0,3601,0,11,283,3954
"1741",2019-10-11,14,41,0,1866,0,4,219,2144
"1742",2019-10-12,1,25,0,1471,0,3,99,1599
"1743",2019-10-13,10,22,0,1632,0,1,98,1763
"1744",2019-10-14,8,62,0,3991,0,12,290,4363
"1745",2019-10-15,20,59,0,3767,0,12,270,4128
"1746",2019-10-16,19,45,0,3879,0,14,291,4248
"1747",2019-10-17,13,40,0,3430,0,14,277,3774
"1748",2019-10-18,13,43,0,2283,0,8,207,2554
"1749",2019-10-19,8,27,0,1439,0,3,85,1562
"1750",2019-10-20,5,25,0,1664,0,2,132,1828
"1751",2019-10-21,9,61,0,4103,0,25,325,4523
"1752",2019-10-22,23,42,0,3885,0,17,310,4277
"1753",2019-10-23,8,37,0,3842,0,23,286,4196
"1754",2019-10-24,16,39,0,3281,0,21,267,3624
"1755",2019-10-25,13,28,0,2284,0,14,208,2547
"1756",2019-10-26,3,22,0,1017,0,0,100,1142
"1757",2019-10-27,2,17,0,1397,0,1,89,1506
"1758",2019-10-28,17,51,0,3906,0,21,309,4304
"1759",2019-10-29,21,42,0,3743,0,18,296,4120
"1760",2019-10-30,15,48,0,3471,0,14,302,3850
"1761",2019-10-31,8,39,0,2824,0,21,247,3139
"1762",2019-11-01,13,28,0,1894,0,19,221,2175
"1763",2019-11-02,4,24,0,1322,0,4,85,1439
"1764",2019-11-03,8,23,0,1725,0,7,110,1873
"1765",2019-11-04,27,51,0,4106,0,27,347,4558
"1766",2019-11-05,24,50,0,3833,0,20,315,4242
"1767",2019-11-06,21,53,0,4023,0,30,332,4459
"1768",2019-11-07,16,44,0,3585,0,14,291,3950
"1769",2019-11-08,16,48,0,2349,0,14,258,2685
"1770",2019-11-09,5,30,0,1374,0,1,97,1507
"1771",2019-11-10,12,23,0,1647,0,1,120,1803
"1772",2019-11-11,18,54,0,4028,0,14,322,4436
"1773",2019-11-12,20,55,0,3916,0,14,311,4316
"1774",2019-11-13,12,62,0,3946,0,22,317,4359
"1775",2019-11-14,16,48,0,3421,0,19,295,3799
"1776",2019-11-15,24,37,0,2456,0,16,226,2759
"1777",2019-11-16,4,25,0,1165,0,5,98,1297
"1778",2019-11-17,10,19,0,1555,0,1,118,1703
"1779",2019-11-18,22,54,0,4193,0,15,313,4597
"1780",2019-11-19,26,50,0,3881,0,17,340,4314
"1781",2019-11-20,19,52,0,4019,0,21,286,4397
"1782",2019-11-21,13,33,0,3628,0,19,270,3963
"1783",2019-11-22,16,49,0,2235,0,5,240,2545
"1784",2019-11-23,4,23,0,1549,0,6,104,1686
"1785",2019-11-24,13,25,0,1802,0,1,127,1968
"1786",2019-11-25,14,55,0,3568,0,19,332,3988
"1787",2019-11-26,23,49,0,2743,0,12,274,3101
"1788",2019-11-27,14,45,0,1495,0,16,229,1799
"1789",2019-11-28,0,0,0,0,0,0,0,0
"1790",2019-11-29,0,0,0,0,0,0,0,0
"1791",2019-11-30,0,0,0,0,0,0,0,0
"1792",2019-12-01,14,28,0,1150,0,0,111,1303
"1793",2019-12-02,10,57,0,3666,0,19,339,4091
"1794",2019-12-03,22,46,0,3451,0,19,312,3850
"1795",2019-12-04,16,45,0,3551,0,28,272,3912
"1796",2019-12-05,7,32,0,3195,0,27,228,3489
"1797",2019-12-06,16,35,0,2040,0,14,221,2326
"1798",2019-12-07,4,24,0,1526,0,1,85,1640
"1799",2019-12-08,12,21,0,1459,0,2,103,1597
"1800",2019-12-09,22,45,0,2156,0,16,272,2511
"1801",2019-12-10,12,34,0,1802,0,15,255,2118
"1802",2019-12-11,18,35,0,1552,0,16,244,1865
"1803",2019-12-12,13,27,0,970,0,11,219,1240
"1804",2019-12-13,21,40,0,764,0,8,213,1046
"1805",2019-12-14,0,0,0,0,0,0,0,0
"1806",2019-12-15,0,0,0,0,0,0,0,0
"1807",2019-12-16,15,10,0,387,0,11,165,588
"1808",2019-12-17,13,22,0,340,0,2,180,557
"1809",2019-12-18,23,26,0,319,0,13,168,549
"1810",2019-12-19,13,20,0,293,0,9,160,495
"1811",2019-12-20,24,25,0,219,0,11,145,424
"1812",2019-12-21,0,0,0,0,0,0,0,0
"1813",2019-12-22,0,0,0,0,0,0,0,0
"1814",2019-12-23,0,0,0,0,0,0,0,0
"1815",2019-12-24,0,0,0,0,0,0,0,0
"1816",2019-12-25,0,0,0,0,0,0,0,0
"1817",2019-12-26,16,14,0,162,0,3,94,289
"1818",2019-12-27,8,24,0,188,0,8,111,339
"1819",2019-12-28,0,0,0,0,0,0,0,0
"1820",2019-12-29,0,0,0,0,0,0,0,0
"1821",2019-12-30,0,0,0,0,0,0,0,0
"1822",2019-12-31,0,0,0,0,0,0,0,0
"1823",2020-01-01,0,0,0,0,0,0,0,0
"1824",2020-01-02,13,27,0,332,0,5,191,568
"1825",2020-01-03,20,28,0,441,0,4,176,669
"1826",2020-01-04,0,0,0,0,0,0,0,0
"1827",2020-01-05,2,10,0,825,0,2,42,881
"1828",2020-01-06,22,63,0,5017,0,19,334,5455
"1829",2020-01-07,18,48,0,4889,0,11,332,5298
"1830",2020-01-08,12,53,0,4931,0,20,344,5360
"1831",2020-01-09,25,33,0,4000,0,21,306,4385
"1832",2020-01-10,24,47,0,2865,0,10,270,3216
"1833",2020-01-11,12,21,0,1828,0,2,123,1986
"1834",2020-01-12,11,24,0,1923,0,1,132,2091
"1835",2020-01-13,22,47,0,4930,0,21,402,5422
"1836",2020-01-14,21,45,0,4884,0,13,379,5342
"1837",2020-01-15,13,49,0,4435,0,23,332,4852
"1838",2020-01-16,22,34,0,4085,0,11,333,4485
"1839",2020-01-17,19,36,0,2466,0,14,294,2829
"1840",2020-01-18,6,19,0,1583,0,8,137,1753
"1841",2020-01-19,8,24,0,1378,0,0,103,1513
"1842",2020-01-20,12,52,0,1886,0,2,163,2115
"1843",2020-01-21,20,50,0,4803,0,15,361,5249
"1844",2020-01-22,22,45,0,4847,0,15,366,5295
"1845",2020-01-23,15,32,0,4116,0,19,335,4517
"1846",2020-01-24,24,37,0,2771,0,13,291,3136
"1847",2020-01-25,5,22,0,1729,0,1,120,1877
"1848",2020-01-26,10,25,0,2325,0,3,140,2503
"1849",2020-01-27,23,50,0,4638,0,20,371,5102
"1850",2020-01-28,20,42,0,4556,0,13,371,5002
"1851",2020-01-29,15,46,0,4476,0,20,344,4901
"1852",2020-01-30,16,39,0,4032,0,18,306,4411
"1853",2020-01-31,15,36,0,2490,0,11,262,2814
"1854",2020-02-01,9,24,0,2259,0,3,150,2445
"1855",2020-02-02,9,22,0,1493,0,0,99,1623
"1856",2020-02-03,13,41,0,4487,0,14,333,4888
"1857",2020-02-04,20,43,0,4504,0,16,334,4917
"1858",2020-02-05,20,55,0,4454,0,9,323,4861
"1859",2020-02-06,23,42,0,4082,0,14,327,4488
"1860",2020-02-07,9,43,0,2404,0,7,280,2743
"1861",2020-02-08,6,17,0,1702,0,5,118,1848
"1862",2020-02-09,7,24,0,2062,0,2,132,2227
"1863",2020-02-10,24,51,0,4465,0,12,334,4886
"1864",2020-02-11,22,55,0,4373,0,17,353,4820
"1865",2020-02-12,12,49,0,4433,0,15,329,4838
"1866",2020-02-13,15,37,0,3646,0,15,308,4021
"1867",2020-02-14,17,36,0,2142,0,8,226,2429
"1868",2020-02-15,5,25,0,1489,0,1,125,1645
"1869",2020-02-16,11,19,0,1933,0,2,109,2074
"1870",2020-02-17,11,43,0,4266,0,16,311,4647
"1871",2020-02-18,23,47,0,4365,0,14,364,4813
"1872",2020-02-19,11,40,0,4169,0,17,321,4558
"1873",2020-02-20,23,39,0,3666,0,37,310,4075
"1874",2020-02-21,14,48,0,2142,0,9,278,2491
"1875",2020-02-22,3,23,0,1367,0,3,118,1514
"1876",2020-02-23,7,37,0,2060,0,1,123,2228
"1877",2020-02-24,9,57,0,4185,0,18,369,4638
"1878",2020-02-25,20,44,0,3861,0,11,345,4281
"1879",2020-02-26,17,53,0,4314,0,15,346,4745
"1880",2020-02-27,19,42,0,3562,0,19,305,3947
"1881",2020-02-28,12,39,0,2121,0,6,237,2415
"1882",2020-02-29,8,24,0,1533,0,5,138,1708
"1883",2020-03-01,6,34,0,1915,0,1,111,2067
"1884",2020-03-02,13,48,0,4185,0,23,332,4601
"1885",2020-03-03,12,53,0,4151,0,17,319,4552
"1886",2020-03-04,10,54,0,4033,0,16,286,4399
"1887",2020-03-05,13,39,0,3613,0,15,272,3952
"1888",2020-03-06,15,47,0,2343,0,11,235,2651
"1889",2020-03-07,6,28,0,1812,0,3,98,1947
"1890",2020-03-08,5,25,0,1652,0,0,119,1801
"1891",2020-03-09,11,39,0,3870,0,17,288,4225
"1892",2020-03-10,13,43,0,3565,0,15,295,3931
"1893",2020-03-11,9,48,0,3389,0,20,243,3709
"1894",2020-03-12,15,31,0,2440,0,10,225,2721
"1895",2020-03-13,5,28,0,1468,0,11,173,1685
"1896",2020-03-14,4,15,0,921,0,3,83,1026
"1897",2020-03-15,5,15,0,783,0,2,71,876
"1898",2020-03-16,8,34,0,820,0,9,144,1015
"1899",2020-03-17,6,28,0,623,0,4,129,790
"1900",2020-03-18,0,0,0,0,0,0,0,0
"1901",2020-03-19,0,0,0,0,0,0,0,0
"1902",2020-03-20,0,0,0,0,0,0,0,0
"1903",2020-03-21,0,0,0,0,0,0,0,0
"1904",2020-03-22,0,0,0,0,0,0,0,0
"1905",2020-03-23,0,0,0,0,0,0,0,0
"1906",2020-03-24,0,0,0,0,0,0,0,0
"1907",2020-03-25,0,0,0,0,0,0,0,0
"1908",2020-03-26,0,0,0,0,0,0,0,0
"1909",2020-03-27,0,0,0,0,0,0,0,0
"1910",2020-03-28,0,0,0,0,0,0,0,0
"1911",2020-03-29,0,0,0,0,0,0,0,0
"1912",2020-03-30,0,0,0,0,0,0,0,0
"1913",2020-03-31,0,0,0,0,0,0,0,0
"1914",2020-04-01,0,0,0,0,0,0,0,0
"1915",2020-04-02,0,0,0,0,0,0,0,0
"1916",2020-04-03,0,0,0,0,0,0,0,0
"1917",2020-04-04,0,0,0,0,0,0,0,0
"1918",2020-04-05,0,0,0,0,0,0,0,0
"1919",2020-04-06,0,0,0,0,0,0,0,0
"1920",2020-04-07,0,0,0,0,0,0,0,0
"1921",2020-04-08,0,0,0,0,0,0,0,0
"1922",2020-04-09,0,0,0,0,0,0,0,0
"1923",2020-04-10,0,0,0,0,0,0,0,0
"1924",2020-04-11,0,0,0,0,0,0,0,0
"1925",2020-04-12,0,0,0,0,0,0,0,0
"1926",2020-04-13,0,0,0,0,0,0,0,0
"1927",2020-04-14,0,0,0,0,0,0,0,0
"1928",2020-04-15,0,0,0,0,0,0,0,0
"1929",2020-04-16,0,0,0,0,0,0,0,0
"1930",2020-04-17,0,0,0,0,0,0,0,0
"1931",2020-04-18,0,0,0,0,0,0,0,0
"1932",2020-04-19,0,0,0,0,0,0,0,0
"1933",2020-04-20,0,0,0,0,0,0,0,0
"1934",2020-04-21,0,0,0,0,0,0,0,0
"1935",2020-04-22,0,0,0,0,0,0,0,0
"1936",2020-04-23,0,0,0,0,0,0,0,0
"1937",2020-04-24,0,0,0,0,0,0,0,0
"1938",2020-04-25,0,0,0,0,0,0,0,0
"1939",2020-04-26,0,0,0,0,0,0,0,0
"1940",2020-04-27,0,0,0,0,0,0,0,0
"1941",2020-04-28,0,0,0,0,0,0,0,0
"1942",2020-04-29,0,0,0,0,0,0,0,0
"1943",2020-04-30,0,0,0,0,0,0,0,0
"1944",2020-05-01,0,0,0,0,0,0,0,0
"1945",2020-05-02,0,0,0,0,0,0,0,0
"1946",2020-05-03,0,0,0,0,0,0,0,0
"1947",2020-05-04,0,0,0,0,0,0,0,0
"1948",2020-05-05,0,0,0,0,0,0,0,0
"1949",2020-05-06,0,0,0,0,0,0,0,0
"1950",2020-05-07,0,0,0,0,0,0,0,0
"1951",2020-05-08,0,0,0,0,0,0,0,0
"1952",2020-05-09,0,0,0,0,0,0,0,0
"1953",2020-05-10,0,0,0,0,0,0,0,0
"1954",2020-05-11,0,0,0,0,0,0,0,0
"1955",2020-05-12,0,0,0,0,0,0,0,0
"1956",2020-05-13,0,0,0,0,0,0,0,0
"1957",2020-05-14,0,0,0,0,0,0,0,0
"1958",2020-05-15,0,0,0,0,0,0,0,0
"1959",2020-05-16,0,0,0,0,0,0,0,0
"1960",2020-05-17,0,0,0,0,0,0,0,0
"1961",2020-05-18,0,0,0,0,0,0,0,0
"1962",2020-05-19,0,0,0,0,0,0,0,0
"1963",2020-05-20,0,0,0,0,0,0,0,0
"1964",2020-05-21,0,0,0,0,0,0,0,0
"1965",2020-05-22,0,0,0,0,0,0,0,0
"1966",2020-05-23,0,0,0,0,0,0,0,0
"1967",2020-05-24,0,0,0,0,0,0,0,0
"1968",2020-05-25,0,0,0,0,0,0,0,0
"1969",2020-05-26,0,0,0,0,0,0,0,0
"1970",2020-05-27,0,0,0,0,0,0,0,0
"1971",2020-05-28,0,0,0,0,0,0,0,0
"1972",2020-05-29,0,0,0,0,0,0,0,0
"1973",2020-05-30,0,0,0,0,0,0,0,0
"1974",2020-05-31,0,0,0,0,0,0,0,0
"1975",2020-06-01,0,0,0,0,0,0,0,0
"1976",2020-06-02,0,0,0,0,0,0,0,0
"1977",2020-06-03,0,0,0,0,0,0,0,0
"1978",2020-06-04,0,0,0,0,0,0,0,0
"1979",2020-06-05,0,0,0,0,0,0,0,0
"1980",2020-06-06,0,0,0,0,0,0,0,0
"1981",2020-06-07,0,0,0,0,0,0,0,0
"1982",2020-06-08,0,0,0,0,0,0,0,0
"1983",2020-06-09,0,0,0,0,0,0,0,0
"1984",2020-06-10,0,0,0,0,0,0,0,0
"1985",2020-06-11,0,0,0,0,0,0,0,0
"1986",2020-06-12,0,0,0,0,0,0,0,0
"1987",2020-06-13,0,0,0,0,0,0,0,0
"1988",2020-06-14,0,0,0,0,0,0,0,0
"1989",2020-06-15,0,0,0,0,0,0,0,0
"1990",2020-06-16,0,0,0,0,0,0,0,0
"1991",2020-06-17,0,0,0,0,0,0,0,0
"1992",2020-06-18,0,0,0,0,0,0,0,0
"1993",2020-06-19,0,0,0,0,0,0,0,0
"1994",2020-06-20,0,0,0,0,0,0,0,0
"1995",2020-06-21,0,0,0,0,0,0,0,0
"1996",2020-06-22,0,0,0,0,0,0,0,0
"1997",2020-06-23,0,0,0,0,0,0,0,0
"1998",2020-06-24,0,0,0,0,0,0,0,0
"1999",2020-06-25,0,0,0,0,0,0,0,0
"2000",2020-06-26,0,0,0,0,0,0,0,0
"2001",2020-06-27,0,0,0,0,0,0,0,0
"2002",2020-06-28,0,0,0,0,0,0,0,0
"2003",2020-06-29,0,0,0,0,0,0,0,0
"2004",2020-06-30,0,0,0,0,0,0,0,0
"2005",2020-07-01,0,0,0,0,0,0,0,0
"2006",2020-07-02,0,0,0,0,0,0,0,0
"2007",2020-07-03,0,0,0,0,0,0,0,0
"2008",2020-07-04,0,0,0,0,0,0,0,0
"2009",2020-07-05,0,0,0,0,0,0,0,0
"2010",2020-07-06,0,0,0,0,0,0,0,0
"2011",2020-07-07,0,0,0,0,0,0,0,0
"2012",2020-07-08,0,0,0,0,0,0,0,0
"2013",2020-07-09,0,0,0,0,0,0,0,0
"2014",2020-07-10,0,0,0,0,0,0,0,0
"2015",2020-07-11,0,0,0,0,0,0,0,0
"2016",2020-07-12,0,0,0,0,0,0,0,0
"2017",2020-07-13,0,0,0,0,0,0,0,0
"2018",2020-07-14,0,0,0,0,0,0,0,0
"2019",2020-07-15,0,0,0,0,0,0,0,0
"2020",2020-07-16,0,0,0,0,0,0,0,0
"2021",2020-07-17,0,0,0,0,0,0,0,0
"2022",2020-07-18,0,0,0,0,0,0,0,0
"2023",2020-07-19,0,0,0,0,0,0,0,0
"2024",2020-07-20,0,0,0,0,0,0,0,0
"2025",2020-07-21,0,0,0,0,0,0,0,0
"2026",2020-07-22,0,0,0,0,0,0,0,0
"2027",2020-07-23,0,0,0,0,0,0,0,0
"2028",2020-07-24,0,0,0,0,0,0,0,0
"2029",2020-07-25,0,0,0,0,0,0,0,0
"2030",2020-07-26,0,0,0,0,0,0,0,0
"2031",2020-07-27,0,0,0,0,0,0,0,0
"2032",2020-07-28,0,0,0,0,0,0,0,0
"2033",2020-07-29,0,0,0,0,0,0,0,0
"2034",2020-07-30,0,0,0,0,0,0,0,0
"2035",2020-07-31,0,0,0,0,0,0,0,0
"2036",2020-08-01,0,0,0,0,0,0,0,0
"2037",2020-08-02,0,0,0,0,0,0,0,0
"2038",2020-08-03,0,0,0,0,0,0,0,0
"2039",2020-08-04,0,0,0,0,0,0,0,0
"2040",2020-08-05,0,0,0,0,0,0,0,0
"2041",2020-08-06,0,0,0,0,0,0,0,0
"2042",2020-08-07,0,0,0,0,0,0,0,0
"2043",2020-08-08,0,0,0,0,0,0,0,0
"2044",2020-08-09,0,0,0,0,0,0,0,0
"2045",2020-08-10,0,0,0,0,0,0,0,0
"2046",2020-08-11,0,0,0,0,0,0,0,0
"2047",2020-08-12,0,0,0,0,0,0,0,0
"2048",2020-08-13,0,0,0,0,0,0,0,0
"2049",2020-08-14,0,0,0,0,0,0,0,0
"2050",2020-08-15,0,0,0,0,0,0,0,0
"2051",2020-08-16,0,0,0,0,0,0,0,0
"2052",2020-08-17,0,0,0,0,0,0,0,0
"2053",2020-08-18,0,0,0,0,0,0,0,0
"2054",2020-08-19,0,0,0,0,0,0,0,0
"2055",2020-08-20,0,0,0,0,0,0,0,0
"2056",2020-08-21,0,0,0,0,0,0,0,0
"2057",2020-08-22,0,0,0,0,0,0,0,0
"2058",2020-08-23,0,0,0,0,0,0,0,0
"2059",2020-08-24,0,0,0,0,0,0,0,0
"2060",2020-08-25,0,0,0,0,0,0,0,0
"2061",2020-08-26,0,0,0,0,0,0,0,0
"2062",2020-08-27,0,0,0,0,0,0,0,0
"2063",2020-08-28,0,0,0,0,0,0,0,0
"2064",2020-08-29,0,0,0,0,0,0,0,0
"2065",2020-08-30,0,0,0,0,0,0,0,0
"2066",2020-08-31,0,0,0,0,0,0,0,0
"2067",2020-09-01,0,0,0,0,0,2,0,2
"2068",2020-09-02,0,0,0,0,0,0,0,0
"2069",2020-09-03,0,0,0,0,0,0,0,0
"2070",2020-09-04,0,0,0,1,0,0,0,1
"2071",2020-09-05,0,0,0,0,0,0,0,0
"2072",2020-09-06,0,0,0,0,0,0,0,0
"2073",2020-09-07,0,0,0,0,0,0,0,0
"2074",2020-09-08,0,0,0,0,0,0,0,0
"2075",2020-09-09,0,0,0,3,0,0,0,3
"2076",2020-09-10,0,0,0,0,0,13,0,13
"2077",2020-09-11,0,0,0,4,0,4,0,8
"2078",2020-09-12,0,0,0,0,0,0,0,0
"2079",2020-09-13,0,0,0,0,0,0,0,0
"2080",2020-09-14,0,0,0,0,0,0,0,0
"2081",2020-09-15,0,0,0,5,0,0,0,5
"2082",2020-09-16,0,0,0,11,0,0,0,11
"2083",2020-09-17,0,0,0,7,0,30,0,37
"2084",2020-09-18,0,0,0,1,0,1,0,2
"2085",2020-09-19,0,0,0,0,0,0,0,0
"2086",2020-09-20,0,0,0,0,0,0,0,0
"2087",2020-09-21,13,0,0,720,0,10,0,743
"2088",2020-09-22,17,0,0,819,0,7,0,843
"2089",2020-09-23,27,0,0,897,0,3,4,931
"2090",2020-09-24,23,0,0,1033,0,5,0,1061
"2091",2020-09-25,24,1,0,1031,0,8,2,1066
"2092",2020-09-26,11,0,0,1021,0,1,0,1033
"2093",2020-09-27,9,0,0,888,0,3,2,902
"2094",2020-09-28,27,1,0,1784,0,4,1,1817
"2095",2020-09-29,33,1,0,1866,0,5,1,1906
"2096",2020-09-30,31,1,0,1778,0,3,2,1815
"2097",2020-10-01,30,0,0,1598,0,2,1,1631
"2098",2020-10-02,34,1,0,1372,0,3,1,1411
"2099",2020-10-03,10,0,0,886,0,3,1,900
"2100",2020-10-04,15,0,0,765,0,1,0,781
"2101",2020-10-05,37,0,0,1764,0,1,2,1804
"2102",2020-10-06,31,1,0,1730,0,2,1,1765
"2103",2020-10-07,30,0,0,1482,0,4,2,1518
"2104",2020-10-08,34,0,0,1537,0,3,2,1576
"2105",2020-10-09,37,0,0,1202,0,1,3,1243
"2106",2020-10-10,19,0,0,710,0,0,0,729
"2107",2020-10-11,19,1,0,662,0,2,0,684
"2108",2020-10-12,44,0,0,1590,0,1,2,1637
"2109",2020-10-13,45,1,0,1551,0,4,2,1603
"2110",2020-10-14,34,0,0,1377,0,4,3,1418
"2111",2020-10-15,29,0,0,1410,0,3,2,1444
"2112",2020-10-16,35,0,0,1222,0,2,5,1264
"2113",2020-10-17,9,0,0,689,0,0,0,698
"2114",2020-10-18,19,0,0,680,0,1,0,700
"2115",2020-10-19,39,0,0,1658,0,4,3,1704
"2116",2020-10-20,41,0,0,1708,0,2,2,1753
"2117",2020-10-21,26,0,0,1476,0,3,2,1507
"2118",2020-10-22,34,0,0,1399,0,3,2,1438
"2119",2020-10-23,29,0,0,1153,0,1,2,1185
"2120",2020-10-24,14,0,0,739,0,0,0,753
"2121",2020-10-25,13,0,0,660,0,1,0,674
"2122",2020-10-26,26,0,0,1578,0,2,3,1609
"2123",2020-10-27,35,0,0,1650,0,1,2,1688
"2124",2020-10-28,34,0,0,1515,0,2,3,1554
"2125",2020-10-29,27,0,0,1380,0,2,2,1411
"2126",2020-10-30,28,0,0,1107,0,0,3,1138
"2127",2020-10-31,16,0,0,646,0,1,0,663
"2128",2020-11-01,11,0,0,492,0,1,0,504
"2129",2020-11-02,35,0,0,1640,0,0,2,1677
"2130",2020-11-03,30,0,0,1746,0,0,2,1778
"2131",2020-11-04,26,0,0,1512,0,2,1,1541
"2132",2020-11-05,34,0,0,1564,0,1,3,1602
"2133",2020-11-06,37,0,0,1345,0,3,1,1386
"2134",2020-11-07,13,0,0,669,0,0,0,682
"2135",2020-11-08,14,0,0,697,0,0,0,711
"2136",2020-11-09,33,0,0,1712,0,0,2,1747
"2137",2020-11-10,37,0,0,1783,0,0,1,1821
"2138",2020-11-11,27,0,0,1509,0,2,3,1541
"2139",2020-11-12,33,0,0,1574,0,3,1,1611
"2140",2020-11-13,29,0,0,1272,0,1,3,1305
"2141",2020-11-14,12,0,0,697,0,1,0,710
"2142",2020-11-15,17,0,0,736,0,2,0,755
"2143",2020-11-16,29,0,0,1513,0,0,3,1545
"2144",2020-11-17,25,0,0,1542,0,2,3,1572
"2145",2020-11-18,0,0,0,0,0,0,0,0
"2146",2020-11-19,0,0,0,0,0,0,0,0
"2147",2020-11-20,0,0,0,0,0,0,0,0
"2148",2020-11-21,0,0,0,0,0,0,0,0
"2149",2020-11-22,0,0,0,0,0,0,0,0
"2150",2020-11-23,0,0,0,1,0,0,0,1
"2151",2020-11-24,0,0,0,1,0,0,0,1
"2152",2020-11-25,0,0,0,0,0,0,0,0
"2153",2020-11-26,0,0,0,0,0,0,0,0
"2154",2020-11-27,0,0,0,0,0,0,0,0
"2155",2020-11-28,0,0,0,0,0,0,0,0
"2156",2020-11-29,0,0,0,0,0,0,0,0
"2157",2020-11-30,0,0,0,0,0,0,0,0
"2158",2020-12-01,0,0,0,0,0,0,0,0
"2159",2020-12-02,0,0,0,0,0,0,0,0
"2160",2020-12-03,0,0,0,0,0,0,0,0
"2161",2020-12-04,0,0,0,0,0,0,0,0
"2162",2020-12-05,0,0,0,0,0,0,0,0
"2163",2020-12-06,0,0,0,0,0,0,0,0
"2164",2020-12-07,0,0,0,1,0,0,0,1
"2165",2020-12-08,0,0,0,0,0,0,0,0
"2166",2020-12-09,0,0,0,0,0,0,1,1
"2167",2020-12-10,0,0,0,0,0,0,0,0
"2168",2020-12-11,0,0,0,0,0,0,0,0
"2169",2020-12-12,0,0,0,0,0,0,0,0
"2170",2020-12-13,0,0,0,0,0,0,0,0
"2171",2020-12-14,0,0,0,0,0,0,0,0
"2172",2020-12-15,0,0,0,0,0,0,0,0
"2173",2020-12-16,0,0,0,0,0,0,0,0
"2174",2020-12-17,0,0,0,0,0,0,0,0
"2175",2020-12-18,0,0,0,0,0,0,0,0
"2176",2020-12-19,0,0,0,0,0,0,0,0
"2177",2020-12-20,0,0,0,0,0,0,0,0
"2178",2020-12-21,0,0,0,0,0,0,0,0
"2179",2020-12-22,0,0,0,0,0,0,0,0
"2180",2020-12-23,0,0,0,0,0,0,0,0
"2181",2020-12-24,0,0,0,0,0,0,0,0
"2182",2020-12-25,0,0,0,0,0,0,0,0
"2183",2020-12-26,0,0,0,0,0,0,0,0
"2184",2020-12-27,0,0,0,0,0,0,0,0
"2185",2020-12-28,0,0,0,0,0,0,0,0
"2186",2020-12-29,0,0,0,0,0,0,0,0
"2187",2020-12-30,0,0,0,0,0,0,0,0
"2188",2020-12-31,0,0,0,0,0,0,0,0
"2189",2021-01-01,0,0,0,0,0,0,0,0
"2190",2021-01-02,0,0,0,0,0,0,0,0
"2191",2021-01-03,0,0,0,0,0,0,0,0
"2192",2021-01-04,0,0,0,0,0,0,0,0
"2193",2021-01-05,0,0,0,0,0,0,0,0
"2194",2021-01-06,0,0,0,0,0,0,0,0
"2195",2021-01-07,0,0,0,0,0,0,0,0
"2196",2021-01-08,0,0,0,1,0,1,0,2
"2197",2021-01-09,0,0,0,0,0,0,0,0
"2198",2021-01-10,0,0,0,0,0,0,0,0
"2199",2021-01-11,0,0,0,268,0,0,1,269
"2200",2021-01-12,0,0,0,343,0,1,2,346
"2201",2021-01-13,0,0,0,255,0,0,0,255
"2202",2021-01-14,1,0,0,352,0,1,0,354
"2203",2021-01-15,0,0,0,240,0,1,0,241
"2204",2021-01-16,0,0,0,158,0,0,0,158
"2205",2021-01-17,0,0,0,146,0,0,0,146
"2206",2021-01-18,0,0,0,222,0,0,1,223
"2207",2021-01-19,1,0,0,323,0,2,2,328
"2208",2021-01-20,0,0,0,290,0,0,1,291
"2209",2021-01-21,0,0,0,383,0,2,0,385
"2210",2021-01-22,0,0,0,274,0,1,0,275
"2211",2021-01-23,0,0,0,169,0,0,0,169
"2212",2021-01-24,0,0,0,142,0,0,0,142
"2213",2021-01-25,0,0,0,336,0,0,1,337
"2214",2021-01-26,1,0,0,360,0,3,1,365
"2215",2021-01-27,0,0,0,313,0,1,1,315
"2216",2021-01-28,1,0,0,404,0,2,0,407
"2217",2021-01-29,0,0,0,284,0,1,0,285
"2218",2021-01-30,0,0,0,182,0,0,0,182
"2219",2021-01-31,0,0,0,190,0,0,0,190
"2220",2021-02-01,0,0,0,306,0,1,1,308
"2221",2021-02-02,1,0,0,435,0,3,1,440
"2222",2021-02-03,0,0,0,417,0,0,1,418
"2223",2021-02-04,0,0,0,436,0,3,1,440
"2224",2021-02-05,0,0,0,327,0,2,0,329
"2225",2021-02-06,0,0,0,203,0,0,0,203
"2226",2021-02-07,0,0,0,156,0,0,0,156
"2227",2021-02-08,0,0,0,347,0,1,1,349
"2228",2021-02-09,1,0,0,399,0,3,2,405
"2229",2021-02-10,0,0,0,359,0,1,1,361
"2230",2021-02-11,1,0,0,403,0,4,1,409
"2231",2021-02-12,0,0,0,292,0,5,0,297
"2232",2021-02-13,0,0,0,231,0,0,0,231
"2233",2021-02-14,0,0,0,148,0,0,0,148
"2234",2021-02-15,0,0,0,343,0,1,1,345
"2235",2021-02-16,1,0,0,393,0,2,2,398
"2236",2021-02-17,0,0,0,379,0,1,1,381
"2237",2021-02-18,0,0,0,395,0,2,2,399
"2238",2021-02-19,0,0,0,321,0,1,0,322
"2239",2021-02-20,0,0,0,228,0,1,0,229
"2240",2021-02-21,0,0,0,168,0,0,0,168
"2241",2021-02-22,0,0,0,380,0,1,1,382
"2242",2021-02-23,0,0,0,427,0,4,3,434
"2243",2021-02-24,0,0,0,375,0,1,1,377
"2244",2021-02-25,0,0,0,427,0,3,2,432
"2245",2021-02-26,0,0,0,11,0,0,0,11
"2246",2021-02-27,0,0,0,0,0,0,0,0
"2247",2021-02-28,0,0,0,0,0,0,0,0
"2248",2021-03-01,0,0,0,932,0,1,1,934
"2249",2021-03-02,0,0,0,976,0,2,2,980
"2250",2021-03-03,0,0,0,971,0,1,1,973
"2251",2021-03-04,0,0,0,982,0,1,2,985
"2252",2021-03-05,0,0,0,860,0,3,0,863
"2253",2021-03-06,0,0,0,436,0,0,0,436
"2254",2021-03-07,0,0,0,390,0,0,0,390
"2255",2021-03-08,0,0,0,1045,0,2,1,1048
"2256",2021-03-09,0,0,0,1074,0,3,3,1080
"2257",2021-03-10,1,0,0,1034,0,3,1,1039
"2258",2021-03-11,0,0,0,1023,0,3,2,1028
"2259",2021-03-12,0,0,0,809,0,2,2,813
"2260",2021-03-13,1,0,0,447,0,0,0,448
"2261",2021-03-14,0,0,0,476,0,2,0,478
"2262",2021-03-15,0,0,0,960,0,1,2,963
"2263",2021-03-16,0,0,0,819,0,0,2,821
"2264",2021-03-17,0,0,0,702,0,0,1,703
"2265",2021-03-18,0,0,0,500,0,2,1,503
"2266",2021-03-19,0,0,0,396,0,0,1,397
"2267",2021-03-20,0,0,0,0,0,0,0,0
"2268",2021-03-21,0,0,0,0,0,0,0,0
"2269",2021-03-22,0,0,0,162,0,1,0,163
"2270",2021-03-23,0,0,0,195,0,1,1,197
"2271",2021-03-24,0,0,0,193,0,0,0,193
"2272",2021-03-25,0,0,0,183,0,1,1,185
"2273",2021-03-26,0,0,0,211,0,0,0,211
"2274",2021-03-27,0,0,0,0,0,0,0,0
"2275",2021-03-28,0,0,0,0,0,0,0,0
"2276",2021-03-29,0,0,0,1255,0,4,0,1259
"2277",2021-03-30,0,0,0,1358,0,4,1,1363
"2278",2021-03-31,0,0,0,1302,0,5,1,1308
"2279",2021-04-01,0,0,0,1264,0,9,1,1274
"2280",2021-04-02,0,0,0,1019,0,2,3,1024
"2281",2021-04-03,0,0,0,532,0,0,0,532
"2282",2021-04-04,0,0,0,501,0,0,0,501
"2283",2021-04-05,0,0,0,1582,0,2,5,1589
"2284",2021-04-06,0,0,0,1626,0,4,6,1636
"2285",2021-04-07,0,0,0,1663,0,2,6,1671
"2286",2021-04-08,0,0,0,1516,0,6,6,1528
"2287",2021-04-09,0,0,0,1142,0,0,4,1146
"2288",2021-04-10,0,0,0,612,0,0,3,615
"2289",2021-04-11,0,0,0,527,0,0,0,527
"2290",2021-04-12,0,0,0,1686,0,4,5,1695
"2291",2021-04-13,0,0,0,1692,0,5,5,1702
"2292",2021-04-14,0,0,0,1607,0,3,7,1617
"2293",2021-04-15,0,0,0,1443,0,2,3,1448
"2294",2021-04-16,0,0,0,1092,0,2,6,1100
"2295",2021-04-17,0,0,0,485,0,1,2,488
"2296",2021-04-18,0,0,0,465,0,3,3,471
"2297",2021-04-19,0,0,0,1587,0,4,8,1599
"2298",2021-04-20,0,0,0,1607,0,2,7,1616
"2299",2021-04-21,0,0,0,1466,0,2,2,1470
"2300",2021-04-22,0,0,0,1319,0,6,5,1330
"2301",2021-04-23,0,0,0,959,0,1,5,965
"2302",2021-04-24,0,0,0,587,0,0,1,588
"2303",2021-04-25,0,0,0,520,0,0,3,523
"2304",2021-04-26,0,0,0,1378,0,5,6,1389
"2305",2021-04-27,0,0,0,1390,0,3,9,1402
"2306",2021-04-28,0,0,0,1249,0,3,6,1258
"2307",2021-04-29,0,0,0,1192,0,4,7,1203
"2308",2021-04-30,0,0,0,252,0,1,1,254
"2309",2021-05-01,0,0,0,214,0,0,1,215
"2310",2021-05-02,0,0,0,224,0,0,1,225
"2311",2021-05-03,0,0,0,567,0,2,3,572
"2312",2021-05-04,0,0,0,631,0,1,4,636
"2313",2021-05-05,0,0,0,598,0,1,2,601
"2314",2021-05-06,0,0,0,524,0,3,4,531
"2315",2021-05-07,0,0,0,612,0,1,6,619
"2316",2021-05-08,0,0,0,473,0,0,1,474
"2317",2021-05-09,0,0,0,410,0,0,1,411
"2318",2021-05-10,0,0,0,1208,0,3,7,1218
"2319",2021-05-11,0,0,0,1284,0,3,7,1294
"2320",2021-05-12,1,0,0,1200,0,4,7,1212
"2321",2021-05-13,0,0,0,1058,0,2,6,1066
"2322",2021-05-14,0,0,0,847,0,1,5,853
"2323",2021-05-15,0,0,0,416,0,0,2,418
"2324",2021-05-16,0,0,0,435,0,0,2,437
"2325",2021-05-17,0,0,0,1268,0,1,11,1280
"2326",2021-05-18,0,0,0,1326,0,2,6,1334
"2327",2021-05-19,0,0,0,1238,0,1,6,1245
"2328",2021-05-20,0,0,0,1128,0,2,6,1136
"2329",2021-05-21,0,0,0,800,0,2,4,806
"2330",2021-05-22,0,0,0,473,0,1,1,475
"2331",2021-05-23,0,0,0,420,0,0,1,421
"2332",2021-05-24,0,0,0,1251,0,2,5,1258
"2333",2021-05-25,0,0,0,1324,0,3,6,1333
"2334",2021-05-26,0,0,0,1291,0,2,8,1301
"2335",2021-05-27,0,0,0,1115,0,5,6,1126
"2336",2021-05-28,0,0,0,872,0,2,7,881
"2337",2021-05-29,0,0,0,407,0,0,2,409
"2338",2021-05-30,0,0,0,363,0,1,5,369
"2339",2021-05-31,0,0,0,598,0,0,6,604
"2340",2021-06-01,0,0,0,1102,0,4,8,1114
"2341",2021-06-02,0,0,0,1133,0,2,4,1139
"2342",2021-06-03,0,0,0,1048,0,4,6,1058
"2343",2021-06-04,0,0,0,775,0,1,6,782
"2344",2021-06-05,0,0,0,454,0,0,4,458
"2345",2021-06-06,0,0,0,365,0,1,4,370
"2346",2021-06-07,0,0,0,836,0,5,7,848
"2347",2021-06-08,0,0,0,766,0,1,5,772
"2348",2021-06-09,0,0,0,635,0,1,7,643
"2349",2021-06-10,0,0,0,386,0,1,6,393
"2350",2021-06-11,0,0,0,337,0,0,2,339
"2351",2021-06-12,0,0,0,0,0,0,0,0
"2352",2021-06-13,0,0,0,0,0,0,0,0
"2353",2021-06-14,1,3,0,111,0,12,62,189
"2354",2021-06-15,0,4,0,103,0,11,86,204
"2355",2021-06-16,0,5,0,116,0,12,99,232
"2356",2021-06-17,0,5,0,100,0,16,78,199
"2357",2021-06-18,0,0,0,0,0,0,0,0
"2358",2021-06-19,0,0,0,0,0,0,0,0
"2359",2021-06-20,0,0,0,0,0,0,0,0
"2360",2021-06-21,0,3,0,140,0,15,135,293
"2361",2021-06-22,0,5,0,158,0,17,141,321
"2362",2021-06-23,0,4,0,139,0,13,142,298
"2363",2021-06-24,0,7,0,128,0,13,126,274
"2364",2021-06-25,0,3,0,126,0,12,111,252
"2365",2021-06-26,0,6,0,44,0,1,46,97
"2366",2021-06-27,0,2,0,32,0,2,45,81
"2367",2021-06-28,0,5,0,146,0,7,166,324
"2368",2021-06-29,0,8,0,141,0,12,176,337
"2369",2021-06-30,0,4,0,134,0,15,158,311
"2370",2021-07-01,0,8,0,115,0,14,137,274
"2371",2021-07-02,0,9,0,98,0,10,131,248
"2372",2021-07-03,0,7,0,43,0,2,71,123
"2373",2021-07-04,0,0,0,0,0,0,0,0
"2374",2021-07-05,0,0,0,0,0,0,0,0
"2375",2021-07-06,3,11,0,150,0,15,207,386
"2376",2021-07-07,0,6,0,160,0,12,170,348
"2377",2021-07-08,1,10,0,152,0,13,170,346
"2378",2021-07-09,0,4,0,119,0,11,158,292
"2379",2021-07-10,1,5,0,59,0,5,81,151
"2380",2021-07-11,1,6,0,53,0,4,64,128
"2381",2021-07-12,1,11,0,180,0,20,196,408
"2382",2021-07-13,1,12,0,170,0,15,195,393
"2383",2021-07-14,2,12,0,178,0,8,184,384
"2384",2021-07-15,1,8,0,152,0,12,164,337
"2385",2021-07-16,2,6,0,149,0,12,163,332
"2386",2021-07-17,0,11,0,81,0,6,78,176
"2387",2021-07-18,0,8,0,63,0,3,79,153
"2388",2021-07-19,2,13,0,187,0,21,209,432
"2389",2021-07-20,3,14,0,192,0,14,196,419
"2390",2021-07-21,1,12,0,186,0,12,207,418
"2391",2021-07-22,2,14,0,158,0,12,166,352
"2392",2021-07-23,7,11,0,131,0,9,163,321
"2393",2021-07-24,3,10,0,59,0,5,80,157
"2394",2021-07-25,3,6,0,64,0,2,75,150
"2395",2021-07-26,3,18,0,191,0,7,207,426
"2396",2021-07-27,4,11,0,200,0,13,186,414
"2397",2021-07-28,2,16,0,190,0,9,191,408
"2398",2021-07-29,3,8,0,175,0,12,175,373
"2399",2021-07-30,2,17,0,123,0,5,148,295
"2400",2021-07-31,4,5,0,66,0,4,80,159
"2401",2021-08-01,0,9,0,50,0,2,81,142
"2402",2021-08-02,5,13,0,159,0,8,209,394
"2403",2021-08-03,5,14,0,159,0,4,197,379
"2404",2021-08-04,6,13,0,154,0,7,194,374
"2405",2021-08-05,6,12,0,144,0,10,156,328
"2406",2021-08-06,4,10,0,128,0,6,167,315
"2407",2021-08-07,1,8,0,66,0,1,71,147
"2408",2021-08-08,2,7,0,65,0,7,78,159
"2409",2021-08-09,1,18,0,161,0,8,205,393
"2410",2021-08-10,4,12,0,159,0,11,186,372
"2411",2021-08-11,5,18,0,155,0,11,196,385
"2412",2021-08-12,4,12,0,147,0,8,169,340
"2413",2021-08-13,2,18,0,134,0,4,146,304
"2414",2021-08-14,4,10,0,75,0,2,59,150
"2415",2021-08-15,7,8,0,58,0,4,69,146
"2416",2021-08-16,6,11,0,158,0,5,197,377
"2417",2021-08-17,8,17,0,161,0,6,186,378
"2418",2021-08-18,8,14,0,162,0,6,171,361
"2419",2021-08-19,6,17,0,149,0,9,157,338
"2420",2021-08-20,6,8,0,130,0,4,128,276
"2421",2021-08-21,2,9,0,73,0,2,70,156
"2422",2021-08-22,7,4,0,58,0,2,75,146
"2423",2021-08-23,6,17,0,185,0,8,188,404
"2424",2021-08-24,5,14,0,183,0,7,178,387
"2425",2021-08-25,6,15,0,178,0,10,169,378
"2426",2021-08-26,7,16,0,171,0,8,156,358
"2427",2021-08-27,8,11,0,146,0,9,157,331
"2428",2021-08-28,0,0,0,0,0,0,0,0
"2429",2021-08-29,0,0,0,0,0,0,0,0
"2430",2021-08-30,0,0,0,0,0,0,0,0
"2431",2021-08-31,0,0,0,0,0,4,0,4
"2432",2021-09-01,0,0,0,0,0,0,0,0
"2433",2021-09-02,0,0,0,0,0,0,0,0
"2434",2021-09-03,0,0,0,0,0,0,0,0
"2435",2021-09-04,0,0,0,0,0,0,0,0
"2436",2021-09-05,0,0,0,0,0,0,0,0
"2437",2021-09-06,0,0,0,0,0,0,0,0
"2438",2021-09-07,0,0,0,0,0,0,0,0
"2439",2021-09-08,0,0,0,0,0,0,0,0
"2440",2021-09-09,0,0,0,1,0,2,0,3
"2441",2021-09-10,0,0,0,0,0,5,0,5
"2442",2021-09-11,0,0,0,0,0,0,0,0
"2443",2021-09-12,0,0,0,0,0,0,0,0
"2444",2021-09-13,3,14,0,209,0,6,141,373
"2445",2021-09-14,0,13,0,395,0,12,130,550
"2446",2021-09-15,1,11,0,478,0,9,135,634
"2447",2021-09-16,4,9,0,478,0,12,135,638
"2448",2021-09-17,2,11,0,492,0,10,118,633
"2449",2021-09-18,0,0,0,0,0,0,0,0
"2450",2021-09-19,0,0,0,0,0,0,0,0
"2451",2021-09-20,4,7,0,1117,0,13,62,1203
"2452",2021-09-21,5,11,0,1261,0,18,62,1357
"2453",2021-09-22,1,14,0,1298,0,10,58,1381
"2454",2021-09-23,5,8,0,1351,0,12,41,1417
"2455",2021-09-24,1,13,0,2222,0,16,56,2308
"2456",2021-09-25,1,5,0,1204,0,1,25,1236
"2457",2021-09-26,3,9,0,1600,0,9,32,1653
"2458",2021-09-27,2,18,0,4188,0,18,93,4319
"2459",2021-09-28,5,21,0,3768,0,27,90,3911
"2460",2021-09-29,1,22,0,3595,0,18,95,3731
"2461",2021-09-30,4,21,0,3226,0,16,99,3366
"2462",2021-10-01,5,19,0,2346,0,0,88,2458
"2463",2021-10-02,2,6,0,1261,0,0,45,1314
"2464",2021-10-03,5,8,0,1426,0,0,36,1475
"2465",2021-10-04,5,25,0,3789,0,2,114,3935
"2466",2021-10-05,8,20,0,3377,0,3,111,3519
"2467",2021-10-06,4,32,0,3256,0,5,125,3422
"2468",2021-10-07,3,20,0,2753,0,1,106,2883
"2469",2021-10-08,5,25,0,1963,0,0,84,2077
"2470",2021-10-09,1,7,0,1265,0,2,57,1332
"2471",2021-10-10,7,12,0,1119,0,1,49,1188
"2472",2021-10-11,6,25,0,3244,0,2,135,3412
"2473",2021-10-12,5,28,0,2999,0,4,116,3152
"2474",2021-10-13,11,31,0,2792,0,1,127,2962
"2475",2021-10-14,8,24,0,2699,0,4,119,2854
"2476",2021-10-15,4,16,0,1485,0,2,96,1603
"2477",2021-10-16,1,12,0,1161,0,0,54,1228
"2478",2021-10-17,8,9,0,1025,0,1,52,1095
"2479",2021-10-18,5,23,0,3289,0,3,139,3459
"2480",2021-10-19,5,32,0,3126,0,4,119,3286
"2481",2021-10-20,8,27,0,3004,0,5,134,3178
"2482",2021-10-21,6,21,0,2631,0,1,112,2771
"2483",2021-10-22,6,21,0,1899,0,3,96,2025
"2484",2021-10-23,4,7,0,1189,0,0,55,1255
"2485",2021-10-24,15,14,0,1078,0,1,50,1158
"2486",2021-10-25,12,22,0,3187,0,3,132,3356
"2487",2021-10-26,5,23,0,3062,0,4,111,3205
"2488",2021-10-27,13,21,0,2938,0,2,120,3094
"2489",2021-10-28,8,19,0,2499,0,3,92,2621
"2490",2021-10-29,9,23,0,1527,0,4,118,1681
"2491",2021-10-30,2,11,0,371,0,0,30,414
"2492",2021-10-31,5,10,0,830,0,1,48,894
"2493",2021-11-01,17,26,0,2691,0,2,118,2854
"2494",2021-11-02,4,24,0,2998,0,5,133,3164
"2495",2021-11-03,5,21,0,2997,0,3,125,3151
"2496",2021-11-04,8,16,0,2691,0,2,123,2840
"2497",2021-11-05,10,21,0,1754,0,1,105,1891
"2498",2021-11-06,5,11,0,1010,0,0,55,1081
"2499",2021-11-07,7,6,0,1059,0,1,56,1129
"2500",2021-11-08,7,29,0,3118,0,2,159,3315
"2501",2021-11-09,5,19,0,3068,0,2,142,3236
"2502",2021-11-10,7,33,0,3147,0,3,151,3341
"2503",2021-11-11,0,0,0,0,0,0,0,0
"2504",2021-11-12,10,27,0,1944,0,4,117,2102
"2505",2021-11-13,7,7,0,1027,0,0,59,1100
"2506",2021-11-14,10,9,0,1126,0,1,55,1201
"2507",2021-11-15,10,31,0,3205,0,1,151,3398
"2508",2021-11-16,5,27,0,3034,0,2,127,3195
"2509",2021-11-17,6,23,0,2796,0,1,137,2963
"2510",2021-11-18,8,19,0,2603,0,2,119,2751
"2511",2021-11-19,8,20,0,1777,0,1,103,1909
"2512",2021-11-20,5,7,0,1059,0,0,55,1126
"2513",2021-11-21,2,12,0,1056,0,1,61,1132
"2514",2021-11-22,17,27,0,2682,0,2,128,2856
"2515",2021-11-23,7,13,0,1924,0,2,122,2068
"2516",2021-11-24,9,16,0,1081,0,0,91,1197
"2517",2021-11-25,0,0,0,0,0,0,0,0
"2518",2021-11-26,0,0,0,0,0,0,0,0
"2519",2021-11-27,0,0,0,0,0,0,0,0
"2520",2021-11-28,0,0,0,0,0,0,0,0
"2521",2021-11-29,10,28,0,2926,0,2,130,3096
"2522",2021-11-30,10,24,0,2938,0,2,122,3096
"2523",2021-12-01,10,22,0,2876,0,0,125,3033
"2524",2021-12-02,6,15,0,2546,0,1,109,2677
"2525",2021-12-03,9,19,0,1608,0,1,110,1747
"2526",2021-12-04,4,9,0,1311,0,0,59,1383
"2527",2021-12-05,8,11,0,1008,0,1,47,1075
"2528",2021-12-06,11,26,0,1601,0,0,115,1753
"2529",2021-12-07,2,21,0,1724,0,2,110,1859
"2530",2021-12-08,5,21,0,1313,0,0,116,1455
"2531",2021-12-09,6,16,0,1049,0,4,82,1157
"2532",2021-12-10,17,18,0,694,0,0,102,831
"2533",2021-12-11,0,0,0,0,0,0,0,0
"2534",2021-12-12,0,0,0,0,0,0,0,0
"2535",2021-12-13,10,10,0,409,0,2,73,504
"2536",2021-12-14,12,12,0,337,0,1,64,426
"2537",2021-12-15,10,5,0,252,0,2,65,334
"2538",2021-12-16,3,6,0,214,0,0,57,280
"2539",2021-12-17,8,13,0,194,0,2,68,285
"2540",2021-12-18,0,0,0,0,0,0,0,0
"2541",2021-12-19,0,0,0,0,0,0,0,0
"2542",2021-12-20,0,0,0,0,0,0,0,0
"2543",2021-12-21,0,0,0,0,0,0,0,0
"2544",2021-12-22,0,0,0,0,0,0,0,0
"2545",2021-12-23,0,0,0,0,0,0,0,0
"2546",2021-12-24,0,0,0,0,0,0,0,0
"2547",2021-12-25,0,0,0,0,0,0,0,0
"2548",2021-12-26,0,0,0,0,0,0,0,0
"2549",2021-12-27,0,0,0,0,0,0,0,0
"2550",2021-12-28,0,0,0,0,0,0,0,0
"2551",2021-12-29,0,0,0,0,0,0,0,0
"2552",2021-12-30,0,0,0,0,0,0,0,0
"2553",2021-12-31,0,0,0,0,0,0,0,0
"2554",2022-01-01,0,0,0,0,0,0,0,0
"2555",2022-01-02,0,0,0,0,0,0,0,0
"2556",2022-01-03,7,26,0,3347,0,5,87,3472
"2557",2022-01-04,14,29,0,3640,0,2,91,3776
"2558",2022-01-05,10,23,0,3610,0,4,112,3759
"2559",2022-01-06,13,24,0,3279,0,0,90,3406
"2560",2022-01-07,10,30,0,2384,0,1,99,2524
"2561",2022-01-08,2,13,0,1601,0,1,44,1661
"2562",2022-01-09,6,8,0,1293,0,0,55,1362
"2563",2022-01-10,4,29,0,3881,0,2,124,4040
"2564",2022-01-11,9,22,0,3817,0,5,123,3976
"2565",2022-01-12,4,25,0,3787,0,2,135,3953
"2566",2022-01-13,11,14,0,3399,0,4,126,3554
"2567",2022-01-14,11,22,0,2139,0,3,98,2273
"2568",2022-01-15,2,11,0,1415,0,3,58,1489
"2569",2022-01-16,8,14,0,1358,0,1,65,1446
"2570",2022-01-17,0,0,0,0,0,0,0,0
"2571",2022-01-18,7,28,0,4196,0,3,128,4362
"2572",2022-01-19,12,31,0,4052,0,6,133,4234
"2573",2022-01-20,11,30,0,3647,0,4,138,3830
"2574",2022-01-21,11,22,0,2334,0,0,100,2467
"2575",2022-01-22,5,13,0,1545,0,2,68,1633
"2576",2022-01-23,8,10,0,1904,0,0,57,1979
"2577",2022-01-24,8,40,0,3776,0,4,140,3968
"2578",2022-01-25,7,36,0,3921,0,1,147,4112
"2579",2022-01-26,10,32,0,3996,0,2,140,4180
"2580",2022-01-27,7,32,0,3572,0,4,138,3753
"2581",2022-01-28,15,28,0,2283,0,1,108,2435
"2582",2022-01-29,7,13,0,1336,0,1,52,1409
"2583",2022-01-30,4,15,0,1754,0,2,62,1837
"2584",2022-01-31,13,41,0,3985,0,3,156,4198
"2585",2022-02-01,7,26,0,4098,0,3,138,4272
"2586",2022-02-02,15,35,0,4142,0,3,147,4342
"2587",2022-02-03,7,30,0,3562,0,2,142,3743
"2588",2022-02-04,10,29,0,2195,0,2,113,2349
"2589",2022-02-05,4,17,0,1441,0,1,56,1519
"2590",2022-02-06,6,17,0,1711,0,1,59,1794
"2591",2022-02-07,8,37,0,3905,0,3,156,4109
"2592",2022-02-08,7,32,0,4103,0,4,144,4290
"2593",2022-02-09,9,30,0,4074,0,2,142,4257
"2594",2022-02-10,7,28,0,3335,0,3,130,3503
"2595",2022-02-11,10,31,0,2195,0,1,108,2345
"2596",2022-02-12,4,16,0,1431,0,0,64,1515
"2597",2022-02-13,5,9,0,915,0,2,49,980
"2598",2022-02-14,9,35,0,3389,0,2,129,3564
"2599",2022-02-15,7,42,0,3713,0,2,139,3903
"2600",2022-02-16,6,34,0,4090,0,2,153,4285
"2601",2022-02-17,10,30,0,3467,0,3,139,3649
"2602",2022-02-18,7,32,0,2283,0,1,127,2450
"2603",2022-02-19,8,19,0,1359,0,0,72,1458
"2604",2022-02-20,9,20,0,1561,0,0,63,1653
"2605",2022-02-21,6,39,0,3779,0,4,128,3956
"2606",2022-02-22,7,35,0,3907,0,3,123,4075
"2607",2022-02-23,9,33,0,3937,0,3,142,4124
"2608",2022-02-24,6,31,0,3161,0,2,128,3328
"2609",2022-02-25,13,22,0,2196,0,5,119,2355
"2610",2022-02-26,10,22,0,1328,0,1,57,1418
"2611",2022-02-27,5,19,0,1750,0,0,62,1836
"2612",2022-02-28,12,41,0,3830,0,3,164,4050
"2613",2022-03-01,12,40,0,3982,0,5,144,4183
"2614",2022-03-02,10,26,0,3866,0,2,142,4046
"2615",2022-03-03,13,32,0,3521,0,4,125,3695
"2616",2022-03-04,8,29,0,2173,0,5,115,2330
"2617",2022-03-05,7,22,0,1441,0,1,61,1532
"2618",2022-03-06,9,18,0,1646,0,1,45,1719
"2619",2022-03-07,7,43,0,3875,0,3,155,4083
"2620",2022-03-08,11,29,0,3511,0,5,136,3692
"2621",2022-03-09,11,36,0,3455,0,3,137,3642
"2622",2022-03-10,9,20,0,3052,0,3,123,3207
"2623",2022-03-11,8,22,0,1893,0,3,121,2047
"2624",2022-03-12,8,15,0,1433,0,0,54,1510
"2625",2022-03-13,9,19,0,1428,0,1,57,1514
"2626",2022-03-14,6,35,0,2061,0,2,110,2214
"2627",2022-03-15,8,32,0,2006,0,1,119,2166
"2628",2022-03-16,7,27,0,1673,0,2,107,1816
"2629",2022-03-17,11,19,0,1118,0,0,98,1246
"2630",2022-03-18,8,21,0,761,0,2,96,888
"2631",2022-03-19,0,0,0,0,0,0,0,0
"2632",2022-03-20,0,0,0,0,0,0,0,0
"2633",2022-03-21,12,22,0,501,0,1,68,604
"2634",2022-03-22,7,13,0,357,0,0,66,443
"2635",2022-03-23,8,18,0,379,0,1,77,483
"2636",2022-03-24,0,0,0,0,0,0,0,0
"2637",2022-03-25,0,0,0,0,0,0,0,0
"2638",2022-03-26,0,0,0,0,0,0,0,0
"2639",2022-03-27,0,0,0,0,0,0,0,0
"2640",2022-03-28,10,34,0,4195,0,4,155,4398
"2641",2022-03-29,9,27,0,4272,0,3,149,4460
"2642",2022-03-30,7,28,0,4410,0,2,153,4600
"2643",2022-03-31,8,25,0,3899,0,2,148,4082
"2644",2022-04-01,14,24,0,2392,0,2,133,2565
"2645",2022-04-02,6,19,0,1463,0,0,70,1558
"2646",2022-04-03,12,17,0,1665,0,1,85,1780
"2647",2022-04-04,15,35,0,4202,0,4,180,4436
"2648",2022-04-05,14,32,0,4238,0,3,182,4469
"2649",2022-04-06,10,35,0,4173,0,4,169,4391
"2650",2022-04-07,5,22,0,3110,0,1,157,3295
"2651",2022-04-08,16,23,0,2165,0,2,144,2350
"2652",2022-04-09,8,18,0,1549,0,1,76,1652
"2653",2022-04-10,12,17,0,1404,0,0,71,1504
"2654",2022-04-11,10,37,0,4122,0,6,190,4365
"2655",2022-04-12,17,32,0,3781,0,3,173,4006
"2656",2022-04-13,15,38,0,3712,0,4,187,3956
"2657",2022-04-14,13,23,0,3139,0,3,162,3340
"2658",2022-04-15,11,22,0,1846,0,2,122,2003
"2659",2022-04-16,10,17,0,1177,0,0,85,1289
"2660",2022-04-17,8,15,0,1082,0,0,61,1166
"2661",2022-04-18,10,37,0,3565,0,4,181,3797
"2662",2022-04-19,11,25,0,3654,0,1,176,3867
"2663",2022-04-20,14,32,0,3362,0,4,167,3579
"2664",2022-04-21,10,26,0,3195,0,2,180,3413
"2665",2022-04-22,15,18,0,2118,0,3,148,2302
"2666",2022-04-23,3,8,0,799,0,0,69,879
"2667",2022-04-24,6,6,0,1308,0,1,64,1385
"2668",2022-04-25,12,31,0,3765,0,3,200,4011
"2669",2022-04-26,14,26,0,3757,0,2,189,3988
"2670",2022-04-27,16,29,0,3808,0,2,169,4024
"2671",2022-04-28,15,28,0,3370,0,2,144,3559
"2672",2022-04-29,16,25,0,2099,0,2,142,2284
"2673",2022-04-30,12,21,0,1458,0,2,103,1596
"2674",2022-05-01,10,13,0,1234,0,0,72,1329
"2675",2022-05-02,12,35,0,3826,0,5,190,4068
"2676",2022-05-03,9,30,0,3796,0,2,187,4024
"2677",2022-05-04,14,33,0,3321,0,4,170,3542
"2678",2022-05-05,10,25,0,3002,0,3,157,3197
"2679",2022-05-06,14,20,0,2030,0,1,150,2215
"2680",2022-05-07,10,16,0,1236,0,1,82,1345
"2681",2022-05-08,9,13,0,1253,0,0,82,1357
"2682",2022-05-09,10,40,0,3856,0,5,203,4114
"2683",2022-05-10,9,33,0,3949,0,1,203,4195
"2684",2022-05-11,14,32,0,3895,0,3,182,4126
"2685",2022-05-12,11,24,0,3226,0,3,170,3434
"2686",2022-05-13,15,19,0,2168,0,2,143,2347
"2687",2022-05-14,8,13,0,1406,0,0,92,1519
"2688",2022-05-15,5,13,0,1260,0,1,80,1359
"2689",2022-05-16,14,39,0,3871,0,3,183,4110
"2690",2022-05-17,12,30,0,3524,0,2,173,3741
"2691",2022-05-18,18,33,0,3596,0,2,179,3828
"2692",2022-05-19,11,27,0,3091,0,2,160,3291
"2693",2022-05-20,20,22,0,1946,0,3,138,2129
"2694",2022-05-21,11,9,0,1083,0,1,73,1177
"2695",2022-05-22,6,16,0,1165,0,0,74,1261
"2696",2022-05-23,15,29,0,3515,0,3,178,3740
"2697",2022-05-24,4,25,0,3384,0,1,162,3576
"2698",2022-05-25,15,30,0,3056,0,2,165,3268
"2699",2022-05-26,9,23,0,2925,0,2,135,3094
"2700",2022-05-27,12,21,0,1903,0,3,133,2072
"2701",2022-05-28,14,14,0,1278,0,0,60,1366
"2702",2022-05-29,10,11,0,1228,0,1,74,1324
"2703",2022-05-30,0,0,0,0,0,0,0,0
"2704",2022-05-31,14,16,0,2362,0,2,118,2512
"2705",2022-06-01,12,36,0,3118,0,3,162,3331
"2706",2022-06-02,16,22,0,2571,0,4,149,2762
"2707",2022-06-03,20,26,0,1812,0,4,128,1990
"2708",2022-06-04,15,15,0,1178,0,2,77,1287
"2709",2022-06-05,13,15,0,1068,0,0,69,1165
"2710",2022-06-06,16,33,0,1901,0,4,146,2100
"2711",2022-06-07,12,25,0,1692,0,3,152,1884
"2712",2022-06-08,15,33,0,1342,0,4,125,1519
"2713",2022-06-09,12,20,0,1113,0,4,111,1260
"2714",2022-06-10,17,18,0,821,0,3,111,970
"2715",2022-06-11,0,0,0,0,0,0,0,0
"2716",2022-06-12,0,0,0,0,0,0,0,0
"2717",2022-06-13,16,6,0,321,0,1,64,408
"2718",2022-06-14,19,12,0,238,0,2,113,384
"2719",2022-06-15,23,15,0,169,0,2,161,370
"2720",2022-06-16,16,13,0,164,0,1,179,373
"2721",2022-06-17,23,15,0,143,0,2,185,368
"2722",2022-06-18,0,0,0,0,0,0,0,0
"2723",2022-06-19,0,0,0,0,0,0,0,0
"2724",2022-06-20,0,0,0,0,0,0,0,0
"2725",2022-06-21,32,17,0,288,0,9,279,625
"2726",2022-06-22,30,18,0,230,0,6,268,552
"2727",2022-06-23,22,13,0,233,0,4,260,532
"2728",2022-06-24,31,11,0,219,0,4,230,495
"2729",2022-06-25,9,2,0,76,0,1,87,175
"2730",2022-06-26,6,2,0,81,0,1,85,175
"2731",2022-06-27,33,19,0,286,0,8,287,633
"2732",2022-06-28,18,16,0,249,0,9,313,605
"2733",2022-06-29,26,17,0,285,0,3,295,626
"2734",2022-06-30,11,15,0,224,0,5,246,501
"2735",2022-07-01,27,16,0,213,0,5,224,485
"2736",2022-07-02,8,6,0,105,0,0,109,228
"2737",2022-07-03,3,8,0,89,0,2,108,210
"2738",2022-07-04,0,0,0,0,0,0,0,0
"2739",2022-07-05,24,24,0,201,0,5,262,516
"2740",2022-07-06,21,16,0,262,0,5,284,588
"2741",2022-07-07,19,17,0,250,0,2,252,540
"2742",2022-07-08,25,13,0,213,0,9,235,495
"2743",2022-07-09,7,6,0,120,0,1,103,237
"2744",2022-07-10,7,9,0,95,0,2,97,210
"2745",2022-07-11,27,18,0,266,0,7,286,604
"2746",2022-07-12,0,0,0,1,0,1,10,12
"2747",2022-07-13,0,0,0,20,0,1,10,31
"2748",2022-07-14,0,0,0,2,0,0,7,9
"2749",2022-07-15,0,0,0,0,0,0,0,0
"2750",2022-07-16,0,0,0,0,0,0,0,0
"2751",2022-07-17,0,0,0,0,0,0,0,0
"2752",2022-07-18,0,0,0,0,0,0,0,0
"2753",2022-07-19,0,0,0,1,0,0,10,11
"2754",2022-07-20,0,0,0,0,0,0,5,5
"2755",2022-07-21,0,0,0,2,0,1,7,10
"2756",2022-07-22,0,0,0,2,0,0,5,7
"2757",2022-07-23,0,0,0,0,0,0,0,0
"2758",2022-07-24,0,0,0,1,0,0,0,1
"2759",2022-07-25,12,21,0,214,0,5,280,532
"2760",2022-07-26,15,21,0,229,0,5,260,530
"2761",2022-07-27,14,19,0,239,0,3,266,541
"2762",2022-07-28,11,13,0,212,0,4,271,511
"2763",2022-07-29,17,14,0,209,0,3,251,494
"2764",2022-07-30,4,8,0,105,0,1,105,223
"2765",2022-07-31,6,9,0,92,0,1,93,201
"2766",2022-08-01,26,22,0,264,0,5,318,635
"2767",2022-08-02,13,13,0,258,0,2,298,584
"2768",2022-08-03,20,16,0,252,0,2,307,597
"2769",2022-08-04,13,12,0,196,0,1,267,489
"2770",2022-08-05,22,23,0,190,0,2,225,462
"2771",2022-08-06,5,7,0,90,0,0,95,197
"2772",2022-08-07,2,7,0,90,0,1,102,202
"2773",2022-08-08,14,22,0,258,0,3,318,615
"2774",2022-08-09,13,16,0,222,0,6,286,543
"2775",2022-08-10,17,17,0,200,0,1,287,522
"2776",2022-08-11,13,18,0,191,0,3,261,486
"2777",2022-08-12,25,16,0,178,0,2,222,443
"2778",2022-08-13,5,5,0,75,0,0,87,172
"2779",2022-08-14,6,3,0,96,0,3,117,225
"2780",2022-08-15,15,20,0,215,0,6,297,553
"2781",2022-08-16,12,13,0,258,0,5,282,570
"2782",2022-08-17,16,19,0,237,0,2,254,528
"2783",2022-08-18,11,13,0,224,0,3,253,504
"2784",2022-08-19,20,16,0,202,0,1,239,478
"2785",2022-08-20,4,7,0,91,0,1,84,187
"2786",2022-08-21,3,4,0,79,0,1,104,191
"2787",2022-08-22,16,16,0,285,0,4,307,628
"2788",2022-08-23,18,11,0,246,0,3,262,540
"2789",2022-08-24,19,15,0,236,0,1,246,517
"2790",2022-08-25,19,13,0,212,0,4,235,483
"2791",2022-08-26,21,14,0,190,0,4,242,471
"2792",2022-08-27,0,0,0,0,0,0,0,0
"2793",2022-08-28,0,0,0,0,0,0,0,0
"2794",2022-08-29,0,0,0,0,0,0,0,0
"2795",2022-08-30,0,0,0,0,0,0,0,0
"2796",2022-08-31,0,0,0,0,0,0,0,0
"2797",2022-09-01,0,0,0,0,0,0,0,0
"2798",2022-09-02,0,0,0,0,0,1,0,1
"2799",2022-09-03,0,0,0,0,0,0,0,0
"2800",2022-09-04,0,0,0,0,0,0,0,0
"2801",2022-09-05,0,0,0,0,0,0,0,0
"2802",2022-09-06,0,0,0,0,0,0,0,0
"2803",2022-09-07,0,0,0,0,0,0,0,0
"2804",2022-09-08,0,0,0,0,0,0,0,0
"2805",2022-09-09,0,0,0,0,0,0,0,0
"2806",2022-09-10,0,0,0,0,0,0,0,0
"2807",2022-09-11,0,0,0,0,0,0,0,0
"2808",2022-09-12,14,16,0,719,0,2,120,871
"2809",2022-09-13,12,12,0,717,0,2,81,824
"2810",2022-09-14,8,19,0,705,0,2,111,845
"2811",2022-09-15,8,10,0,655,0,1,81,755
"2812",2022-09-16,10,20,0,784,0,2,87,903
"2813",2022-09-17,0,0,0,0,0,0,0,0
"2814",2022-09-18,0,0,0,0,0,0,0,0
"2815",2022-09-19,17,23,0,1468,0,6,89,1603
"2816",2022-09-20,11,14,0,1535,0,6,76,1642
"2817",2022-09-21,18,22,0,1582,0,5,84,1711
"2818",2022-09-22,4,14,0,1819,0,4,85,1926
"2819",2022-09-23,14,18,0,2064,0,1,78,2175
"2820",2022-09-24,3,10,0,1553,0,0,36,1602
"2821",2022-09-25,8,12,0,1876,0,1,53,1950
"2822",2022-09-26,23,25,0,3950,0,4,129,4131
"2823",2022-09-27,15,20,0,5301,0,2,160,5498
"2824",2022-09-28,18,25,0,4841,0,5,121,5010
"2825",2022-09-29,12,20,0,4239,0,4,120,4395
"2826",2022-09-30,11,19,0,3004,0,6,113,3153
"2827",2022-10-01,12,13,0,1580,0,0,56,1661
"2828",2022-10-02,7,14,0,1682,0,0,53,1756
"2829",2022-10-03,13,37,0,4700,0,1,139,4890
"2830",2022-10-04,8,23,0,4549,0,2,143,4725
"2831",2022-10-05,16,26,0,4111,0,3,155,4311
"2832",2022-10-06,10,27,0,3710,0,4,153,3904
"2833",2022-10-07,12,27,0,2571,0,0,121,2731
"2834",2022-10-08,4,14,0,1473,0,0,56,1547
"2835",2022-10-09,14,19,0,1420,0,3,64,1520
"2836",2022-10-10,13,28,0,4185,0,3,156,4385
"2837",2022-10-11,13,31,0,3950,0,4,155,4153
"2838",2022-10-12,20,23,0,3834,0,4,149,4030
"2839",2022-10-13,10,23,0,3574,0,2,148,3757
"2840",2022-10-14,15,26,0,2399,0,1,106,2547
"2841",2022-10-15,6,15,0,1477,0,0,63,1561
"2842",2022-10-16,8,19,0,1321,0,0,57,1405
"2843",2022-10-17,19,37,0,4047,0,0,157,4260
"2844",2022-10-18,14,28,0,4013,0,1,158,4214
"2845",2022-10-19,10,36,0,3961,0,2,152,4161
"2846",2022-10-20,14,21,0,3649,0,3,168,3855
"2847",2022-10-21,22,28,0,2126,0,2,104,2282
"2848",2022-10-22,5,8,0,605,0,0,56,674
"2849",2022-10-23,7,18,0,1456,0,1,62,1544
"2850",2022-10-24,16,30,0,4008,0,1,146,4201
"2851",2022-10-25,11,25,0,3965,0,3,165,4169
"2852",2022-10-26,18,26,0,3679,0,5,152,3880
"2853",2022-10-27,13,21,0,3104,0,2,141,3281
"2854",2022-10-28,23,27,0,2017,0,6,115,2188
"2855",2022-10-29,7,14,0,1261,0,0,62,1344
"2856",2022-10-30,6,21,0,1232,0,0,61,1320
"2857",2022-10-31,17,33,0,3311,0,1,134,3496
"2858",2022-11-01,12,28,0,3688,0,3,159,3890
"2859",2022-11-02,19,29,0,3790,0,1,152,3991
"2860",2022-11-03,11,27,0,3393,0,3,145,3579
"2861",2022-11-04,18,27,0,2309,0,3,116,2473
"2862",2022-11-05,10,15,0,1414,0,3,65,1507
"2863",2022-11-06,19,17,0,1554,0,0,75,1665
"2864",2022-11-07,15,37,0,4003,0,4,156,4215
"2865",2022-11-08,11,33,0,4145,0,2,168,4359
"2866",2022-11-09,14,27,0,3921,0,3,148,4113
"2867",2022-11-10,7,30,0,3511,0,3,171,3722
"2868",2022-11-11,0,0,0,0,0,0,0,0
"2869",2022-11-12,13,29,0,1007,0,1,76,1126
"2870",2022-11-13,5,23,0,1522,0,0,69,1619
"2871",2022-11-14,12,30,0,3913,0,2,143,4100
"2872",2022-11-15,11,22,0,3850,0,2,172,4057
"2873",2022-11-16,12,34,0,3759,0,3,143,3951
"2874",2022-11-17,5,27,0,3186,0,2,143,3363
"2875",2022-11-18,24,26,0,2151,0,2,123,2326
"2876",2022-11-19,6,14,0,1128,0,3,73,1224
"2877",2022-11-20,16,14,0,1223,0,0,76,1329
"2878",2022-11-21,21,27,0,2962,0,2,144,3156
"2879",2022-11-22,22,23,0,2448,0,4,158,2655
"2880",2022-11-23,18,27,0,1212,0,3,99,1359
"2881",2022-11-24,0,0,0,0,0,0,0,0
"2882",2022-11-25,0,0,0,0,0,0,0,0
"2883",2022-11-26,0,0,0,0,0,0,0,0
"2884",2022-11-27,0,0,0,0,0,0,0,0
"2885",2022-11-28,21,33,0,3410,0,1,164,3629
"2886",2022-11-29,12,32,0,3552,0,3,153,3752
"2887",2022-11-30,22,30,0,3460,0,4,128,3644
"2888",2022-12-01,10,18,0,2918,0,2,135,3083
"2889",2022-12-02,24,27,0,2101,0,3,114,2269
"2890",2022-12-03,11,20,0,1569,0,1,66,1667
"2891",2022-12-04,15,11,0,1456,0,0,63,1545
"2892",2022-12-05,22,26,0,2218,0,2,125,2393
"2893",2022-12-06,13,19,0,2055,0,2,140,2229
"2894",2022-12-07,15,21,0,1826,0,3,117,1982
"2895",2022-12-08,15,25,0,1429,0,3,115,1587
"2896",2022-12-09,18,25,0,910,0,2,101,1056
"2897",2022-12-10,0,0,0,0,0,0,0,0
"2898",2022-12-11,0,0,0,0,0,0,0,0
"2899",2022-12-12,0,0,0,0,0,0,0,0
"2900",2022-12-13,0,0,0,0,0,0,0,0
"2901",2022-12-14,0,0,0,0,0,0,0,0
"2902",2022-12-15,0,0,0,0,0,0,0,0
"2903",2022-12-16,0,0,0,0,0,0,0,0
"2904",2022-12-17,0,0,0,0,0,0,0,0
"2905",2022-12-18,0,0,0,0,0,0,0,0
"2906",2022-12-19,0,0,0,0,0,0,0,0
"2907",2022-12-20,0,0,0,0,0,0,0,0
"2908",2022-12-21,0,0,0,0,0,0,0,0
"2909",2022-12-22,0,0,0,0,0,0,0,0
"2910",2022-12-23,0,0,0,0,0,0,0,0
"2911",2022-12-24,0,0,0,0,0,0,0,0
"2912",2022-12-25,0,0,0,0,0,0,0,0
"2913",2022-12-26,0,0,0,0,0,0,0,0
"2914",2022-12-27,0,0,0,0,0,0,0,0
"2915",2022-12-28,0,0,0,0,0,0,0,0
"2916",2022-12-29,0,0,0,0,0,0,0,0
"2917",2022-12-30,0,0,0,0,0,0,0,0
"2918",2022-12-31,0,0,0,0,0,0,0,0
"2919",2023-01-01,0,0,0,0,0,0,0,0
"2920",2023-01-02,0,0,0,0,0,0,0,0
"2921",2023-01-03,7,17,0,270,0,3,77,374
"2922",2023-01-04,7,25,0,402,0,1,74,509
"2923",2023-01-05,12,21,0,504,0,1,86,624
"2924",2023-01-06,9,23,0,646,0,2,86,766
"2925",2023-01-07,0,0,0,0,0,0,0,0
"2926",2023-01-08,0,0,0,0,0,0,0,0
"2927",2023-01-09,11,39,0,5264,0,3,166,5483
"2928",2023-01-10,14,36,0,5510,0,2,164,5726
"2929",2023-01-11,12,44,0,5125,0,2,166,5349
"2930",2023-01-12,8,22,0,4538,0,1,165,4734
"2931",2023-01-13,21,30,0,3215,0,2,135,3403
"2932",2023-01-14,10,24,0,1902,0,3,82,2021
"2933",2023-01-15,11,18,0,2027,0,0,78,2134
"2934",2023-01-16,0,0,0,0,0,0,0,0
"2935",2023-01-17,13,35,0,5570,0,3,198,5819
"2936",2023-01-18,7,47,0,5277,0,2,172,5505
"2937",2023-01-19,14,32,0,4749,0,4,220,5019
"2938",2023-01-20,18,22,0,3019,0,2,140,3201
"2939",2023-01-21,6,20,0,2006,0,2,89,2123
"2940",2023-01-22,18,12,0,1796,0,2,82,1910
"2941",2023-01-23,11,46,0,5084,0,3,214,5358
"2942",2023-01-24,12,43,0,5190,0,3,203,5451
"2943",2023-01-25,22,47,0,4755,0,5,183,5012
"2944",2023-01-26,9,35,0,4426,0,2,210,4682
"2945",2023-01-27,13,32,0,2978,0,3,140,3166
"2946",2023-01-28,18,24,0,1874,0,0,98,2014
"2947",2023-01-29,18,12,0,2009,0,0,80,2119
"2948",2023-01-30,15,34,0,4818,0,2,188,5057
"2949",2023-01-31,19,37,0,4955,0,2,186,5199
"2950",2023-02-01,14,34,0,4834,0,0,154,5036
"2951",2023-02-02,14,37,0,4395,0,3,179,4628
"2952",2023-02-03,16,33,0,3013,0,5,130,3197
"2953",2023-02-04,17,20,0,2024,0,2,89,2152
"2954",2023-02-05,18,22,0,2216,0,1,81,2338
"2955",2023-02-06,17,37,0,4986,0,4,203,5247
"2956",2023-02-07,20,37,0,4986,0,3,207,5253
"2957",2023-02-08,20,39,0,4840,0,3,198,5100
"2958",2023-02-09,11,24,0,4040,0,3,186,4264
"2959",2023-02-10,16,33,0,2665,0,5,152,2871
"2960",2023-02-11,8,22,0,1889,0,4,71,1994
"2961",2023-02-12,10,17,0,1231,0,0,58,1316
"2962",2023-02-13,19,44,0,4485,0,3,183,4734
"2963",2023-02-14,12,28,0,4265,0,1,159,4465
"2964",2023-02-15,21,50,0,4717,0,6,195,4989
"2965",2023-02-16,10,35,0,4331,0,4,202,4582
"2966",2023-02-17,8,37,0,2603,0,5,147,2800
"2967",2023-02-18,11,25,0,1644,0,2,104,1786
"2968",2023-02-19,12,23,0,1858,0,2,80,1975
"2969",2023-02-20,20,45,0,4381,0,4,172,4622
"2970",2023-02-21,12,37,0,4859,0,6,212,5126
"2971",2023-02-22,21,49,0,4682,0,3,186,4941
"2972",2023-02-23,12,36,0,4175,0,5,175,4403
"2973",2023-02-24,17,36,0,2855,0,7,125,3040
"2974",2023-02-25,12,24,0,1575,0,0,89,1700
"2975",2023-02-26,11,27,0,2045,0,1,90,2174
"2976",2023-02-27,16,49,0,4599,0,3,174,4841
"2977",2023-02-28,26,38,0,4812,0,3,180,5059
"2978",2023-03-01,15,47,0,4628,0,4,189,4883
"2979",2023-03-02,15,27,0,4290,0,3,176,4511
"2980",2023-03-03,10,40,0,2863,0,2,131,3046
"2981",2023-03-04,14,30,0,1732,0,0,94,1870
"2982",2023-03-05,16,29,0,2018,0,2,81,2146
"2983",2023-03-06,13,48,0,4792,0,4,191,5048
"2984",2023-03-07,15,40,0,4713,0,4,192,4964
"2985",2023-03-08,16,54,0,4519,0,4,161,4754
"2986",2023-03-09,14,31,0,4359,0,5,157,4566
"2987",2023-03-10,19,33,0,2818,0,4,138,3012
"2988",2023-03-11,8,28,0,1557,0,2,78,1673
"2989",2023-03-12,16,26,0,1880,0,2,84,2008
"2990",2023-03-13,20,40,0,4220,0,3,179,4462
"2991",2023-03-14,13,34,0,4227,0,4,192,4470
"2992",2023-03-15,15,40,0,4130,0,5,171,4361
"2993",2023-03-16,13,37,0,3712,0,2,149,3913
"2994",2023-03-17,17,30,0,2069,0,6,129,2251
"2995",2023-03-18,9,19,0,1373,0,1,76,1478
"2996",2023-03-19,21,20,0,1425,0,1,76,1543
"2997",2023-03-20,16,39,0,2408,0,4,172,2639
"2998",2023-03-21,12,31,0,2142,0,1,155,2341
"2999",2023-03-22,13,39,0,1745,0,2,149,1948
"3000",2023-03-23,25,36,0,1346,0,2,132,1541
"3001",2023-03-24,13,31,0,880,0,3,123,1050
"3002",2023-03-25,0,0,0,0,0,0,0,0
"3003",2023-03-26,0,0,0,0,0,0,0,0
"3004",2023-03-27,10,15,0,471,0,2,89,587
"3005",2023-03-28,9,18,0,434,0,0,68,529
"3006",2023-03-29,11,15,0,390,0,2,77,495
"3007",2023-03-30,10,17,0,387,0,0,54,468
"3008",2023-03-31,17,21,0,473,0,2,81,594
"3009",2023-04-01,0,0,0,0,0,0,0,0
"3010",2023-04-02,0,0,0,0,0,0,0,0
"3011",2023-04-03,21,39,0,4824,0,6,153,5043
"3012",2023-04-04,21,34,0,5243,0,6,176,5480
"3013",2023-04-05,21,47,0,4867,0,6,184,5125
"3014",2023-04-06,16,31,0,4581,0,1,175,4804
"3015",2023-04-07,17,35,0,3170,0,0,149,3371
"3016",2023-04-08,17,27,0,1748,0,3,98,1893
"3017",2023-04-09,13,26,0,1627,0,2,77,1745
"3018",2023-04-10,17,39,0,4957,0,5,209,5227
"3019",2023-04-11,7,46,0,5212,0,2,231,5498
"3020",2023-04-12,23,47,0,4854,0,5,211,5140
"3021",2023-04-13,13,31,0,4343,0,3,196,4586
"3022",2023-04-14,20,35,0,2630,0,3,134,2822
"3023",2023-04-15,10,29,0,1486,0,1,92,1618
"3024",2023-04-16,17,29,0,1660,0,0,100,1806
"3025",2023-04-17,22,52,0,4538,0,4,219,4835
"3026",2023-04-18,17,45,0,4801,0,3,231,5097
"3027",2023-04-19,27,50,0,4424,0,4,229,4734
"3028",2023-04-20,19,30,0,3684,0,3,200,3936
"3029",2023-04-21,20,42,0,2866,0,3,161,3092
"3030",2023-04-22,10,22,0,1556,0,2,100,1690
"3031",2023-04-23,17,25,0,1633,0,2,105,1782
"3032",2023-04-24,20,47,0,4538,0,8,249,4862
"3033",2023-04-25,15,37,0,4568,0,4,214,4838
"3034",2023-04-26,19,45,0,4008,0,3,191,4266
"3035",2023-04-27,14,38,0,3586,0,3,191,3832
"3036",2023-04-28,11,29,0,1941,0,3,142,2126
"3037",2023-04-29,8,23,0,793,0,1,60,885
"3038",2023-04-30,13,26,0,1516,0,0,66,1621
"3039",2023-05-01,9,39,0,4419,0,4,209,4680
"3040",2023-05-02,16,41,0,4708,0,3,226,4994
"3041",2023-05-03,18,38,0,4348,0,2,211,4617
"3042",2023-05-04,15,48,0,4020,0,6,201,4290
"3043",2023-05-05,20,34,0,2741,0,5,152,2952
"3044",2023-05-06,13,26,0,1651,0,1,97,1788
"3045",2023-05-07,13,32,0,1500,0,1,87,1633
"3046",2023-05-08,17,51,0,4135,0,7,216,4426
"3047",2023-05-09,16,39,0,4687,0,5,227,4974
"3048",2023-05-10,11,51,0,4013,0,7,226,4308
"3049",2023-05-11,19,29,0,3722,0,3,194,3967
"3050",2023-05-12,16,36,0,2111,0,3,154,2320
"3051",2023-05-13,12,20,0,1050,0,1,87,1170
"3052",2023-05-14,13,16,0,1004,0,1,68,1102
"3053",2023-05-15,17,39,0,4132,0,3,217,4408
"3054",2023-05-16,23,44,0,4399,0,6,209,4681
"3055",2023-05-17,24,47,0,3951,0,8,215,4245
"3056",2023-05-18,19,29,0,3709,0,3,161,3921
"3057",2023-05-19,16,32,0,2220,0,3,142,2413
"3058",2023-05-20,13,21,0,1408,0,1,57,1500
"3059",2023-05-21,18,24,0,1415,0,1,71,1529
"3060",2023-05-22,16,40,0,4171,0,3,188,4418
"3061",2023-05-23,17,33,0,4291,0,4,206,4551
"3062",2023-05-24,20,38,0,3913,0,3,202,4176
"3063",2023-05-25,19,25,0,3257,0,4,154,3459
"3064",2023-05-26,17,30,0,1957,0,2,134,2140
"3065",2023-05-27,6,13,0,1175,0,0,80,1274
"3066",2023-05-28,12,17,0,1290,0,2,80,1401
"3067",2023-05-29,0,0,0,0,0,0,0,0
"3068",2023-05-30,21,35,0,4061,0,3,199,4319
"3069",2023-05-31,27,39,0,3895,0,3,198,4162
"3070",2023-06-01,15,25,0,3383,0,4,170,3597
"3071",2023-06-02,17,32,0,2299,0,1,153,2502
"3072",2023-06-03,14,12,0,1350,0,2,89,1467
"3073",2023-06-04,9,21,0,1358,0,1,67,1456
"3074",2023-06-05,23,39,0,3680,0,3,192,3937
"3075",2023-06-06,20,32,0,3608,0,4,173,3837
"3076",2023-06-07,28,43,0,3658,0,7,196,3932
"3077",2023-06-08,12,16,0,2268,0,4,114,2414
"3078",2023-06-09,28,24,0,2091,0,1,137,2281
"3079",2023-06-10,13,16,0,1151,0,3,69,1252
"3080",2023-06-11,14,17,0,1118,0,0,70,1219
"3081",2023-06-12,22,34,0,1892,0,3,167,2118
"3082",2023-06-13,31,27,0,1893,0,3,162,2116
"3083",2023-06-14,23,25,0,1456,0,1,149,1654
"3084",2023-06-15,24,22,0,1081,0,3,128,1258
"3085",2023-06-16,24,28,0,873,0,2,119,1046
"3086",2023-06-17,0,0,0,0,0,0,0,0
"3087",2023-06-18,0,0,0,0,0,0,0,0
"3088",2023-06-19,0,0,0,0,0,0,0,0
"3089",2023-06-20,17,9,0,107,0,3,143,279
"3090",2023-06-21,21,15,0,140,0,9,158,343
"3091",2023-06-22,15,19,0,124,0,9,182,349
"3092",2023-06-23,20,11,0,129,0,5,168,333
"3093",2023-06-24,0,0,0,0,0,0,0,0
"3094",2023-06-25,0,0,0,0,0,0,0,0
"3095",2023-06-26,28,33,0,319,0,15,274,669
"3096",2023-06-27,23,25,0,277,0,17,280,622
"3097",2023-06-28,29,28,0,273,0,19,274,623
"3098",2023-06-29,16,31,0,238,0,12,247,544
"3099",2023-06-30,17,20,0,190,0,9,243,479
"3100",2023-07-01,13,15,0,64,0,6,81,179
"3101",2023-07-02,0,0,0,0,0,0,0,0
"3102",2023-07-03,24,26,0,258,0,15,285,608
"3103",2023-07-04,0,0,0,0,0,0,0,0
"3104",2023-07-05,14,33,0,233,0,14,306,600
"3105",2023-07-06,19,26,0,240,0,14,302,601
"3106",2023-07-07,18,21,0,213,0,12,257,521
"3107",2023-07-08,4,14,0,110,0,8,125,261
"3108",2023-07-09,0,0,0,0,0,0,0,0
"3109",2023-07-10,17,29,0,296,0,23,345,710
"3110",2023-07-11,10,25,0,298,0,21,332,686
"3111",2023-07-12,19,30,0,297,0,18,311,675
"3112",2023-07-13,13,19,0,256,0,14,280,582
"3113",2023-07-14,21,22,0,217,0,13,225,498
"3114",2023-07-15,6,14,0,100,0,5,101,226
"3115",2023-07-16,0,0,0,0,0,0,0,0
"3116",2023-07-17,26,35,0,299,0,17,376,753
"3117",2023-07-18,24,29,0,269,0,15,324,661
"3118",2023-07-19,24,31,0,267,0,20,324,666
"3119",2023-07-20,38,19,0,242,0,16,271,586
"3120",2023-07-21,18,17,0,187,0,8,228,458
"3121",2023-07-22,10,12,0,102,0,8,123,255
"3122",2023-07-23,0,0,0,0,0,0,0,0
"3123",2023-07-24,30,36,0,291,0,25,351,733
"3124",2023-07-25,22,17,0,264,0,16,307,626
"3125",2023-07-26,26,29,0,276,0,15,299,645
"3126",2023-07-27,26,19,0,228,0,15,255,543
"3127",2023-07-28,23,17,0,175,0,12,232,459
"3128",2023-07-29,6,20,0,106,0,6,117,255
"3129",2023-07-30,0,0,0,0,0,0,0,0
"3130",2023-07-31,18,26,0,300,0,24,346,714
"3131",2023-08-01,14,33,0,288,0,14,316,665
"3132",2023-08-02,20,28,0,263,0,21,316,648
"3133",2023-08-03,13,19,0,244,0,15,265,556
"3134",2023-08-04,15,25,0,176,0,12,228,456
"3135",2023-08-05,7,21,0,85,0,3,120,236
"3136",2023-08-06,0,0,0,0,0,0,0,0
"3137",2023-08-07,22,34,0,308,0,11,352,727
"3138",2023-08-08,16,25,0,266,0,13,311,631
"3139",2023-08-09,21,28,0,280,0,10,285,624
"3140",2023-08-10,17,15,0,236,0,7,232,507
"3141",2023-08-11,23,24,0,174,0,3,221,445
"3142",2023-08-12,6,17,0,96,0,5,108,232
"3143",2023-08-13,0,0,0,0,0,0,0,0
"3144",2023-08-14,28,39,0,263,0,9,326,665
"3145",2023-08-15,8,5,0,96,0,3,75,187
"3146",2023-08-16,26,36,0,266,0,18,304,650
"3147",2023-08-17,26,24,0,212,0,4,293,559
"3148",2023-08-18,25,20,0,168,0,10,232,455
"3149",2023-08-19,5,18,0,86,0,2,124,235
"3150",2023-08-20,0,0,0,0,0,0,0,0
"3151",2023-08-21,24,34,0,320,0,12,332,722
"3152",2023-08-22,22,25,0,296,0,8,285,636
"3153",2023-08-23,22,23,0,273,0,17,301,636
"3154",2023-08-24,33,20,0,236,0,3,273,565
"3155",2023-08-25,23,24,0,199,0,9,226,481
"3156",2023-08-26,0,0,0,0,0,0,0,0
"3157",2023-08-27,0,0,0,0,0,0,0,0
"3158",2023-08-28,0,0,0,0,0,0,0,0
"3159",2023-08-29,0,0,0,0,0,0,0,0
"3160",2023-08-30,0,0,0,0,0,0,0,0
"3161",2023-08-31,0,0,0,0,0,0,0,0
"3162",2023-09-01,0,0,0,0,0,0,0,0
"3163",2023-09-02,0,0,0,0,0,0,0,0
"3164",2023-09-03,0,0,0,0,0,0,0,0
"3165",2023-09-04,0,0,0,0,0,0,0,0
"3166",2023-09-05,0,0,0,0,0,0,0,0
"3167",2023-09-06,0,0,0,0,0,0,0,0
"3168",2023-09-07,0,0,0,0,0,0,0,0
"3169",2023-09-08,0,0,0,0,0,0,0,0
"3170",2023-09-09,0,0,0,0,0,0,0,0
"3171",2023-09-10,0,0,0,0,0,0,0,0
"3172",2023-09-11,17,24,0,516,0,11,269,837
"3173",2023-09-12,17,22,0,533,0,11,233,816
"3174",2023-09-13,10,25,0,600,0,17,262,914
"3175",2023-09-14,12,21,0,591,0,14,221,859
"3176",2023-09-15,10,26,0,594,0,14,234,878
"3177",2023-09-16,0,0,0,0,0,0,0,0
"3178",2023-09-17,0,0,0,0,0,0,0,0
"3179",2023-09-18,14,22,0,1346,0,14,101,1497
"3180",2023-09-19,16,24,0,1482,0,7,100,1629
"3181",2023-09-20,14,27,0,1531,0,6,86,1664
"3182",2023-09-21,14,20,0,1722,0,6,72,1834
"3183",2023-09-22,10,32,0,2225,0,5,90,2362
"3184",2023-09-23,0,0,0,0,0,0,0,0
"3185",2023-09-24,5,14,0,2250,0,1,46,2316
"3186",2023-09-25,22,42,0,4448,0,5,130,4647
"3187",2023-09-26,13,38,0,5868,0,7,161,6087
"3188",2023-09-27,20,42,0,4938,0,6,143,5149
"3189",2023-09-28,17,36,0,4499,0,6,131,4689
"3190",2023-09-29,11,36,0,3191,0,4,128,3370
"3191",2023-09-30,5,19,0,2007,0,0,60,2091
"3192",2023-10-01,13,19,0,2003,0,0,65,2100
"3193",2023-10-02,14,48,0,4923,0,3,169,5157
"3194",2023-10-03,23,47,0,5167,0,2,167,5406
"3195",2023-10-04,16,44,0,4533,0,3,159,4755
"3196",2023-10-05,18,39,0,4010,0,2,142,4211
"3197",2023-10-06,13,34,0,3001,0,2,125,3175
"3198",2023-10-07,6,15,0,1779,0,0,48,1848
"3199",2023-10-08,12,20,0,1638,0,0,65,1735
"3200",2023-10-09,10,52,0,4343,0,3,175,4583
"3201",2023-10-10,24,40,0,4302,0,2,171,4539
"3202",2023-10-11,14,46,0,3821,0,2,180,4063
"3203",2023-10-12,11,39,0,3643,0,1,151,3845
"3204",2023-10-13,14,37,0,2251,0,2,132,2436
"3205",2023-10-14,4,16,0,1341,0,0,52,1413
"3206",2023-10-15,10,19,0,1655,0,0,70,1754
"3207",2023-10-16,17,47,0,4419,0,1,184,4668
"3208",2023-10-17,18,53,0,4664,0,1,189,4925
"3209",2023-10-18,16,41,0,4156,0,3,175,4391
"3210",2023-10-19,12,39,0,3663,0,3,147,3864
"3211",2023-10-20,9,36,0,2390,0,3,128,2566
"3212",2023-10-21,4,17,0,831,0,1,50,903
"3213",2023-10-22,14,17,0,1734,0,0,77,1842
"3214",2023-10-23,14,50,0,4424,0,3,197,4688
"3215",2023-10-24,17,45,0,4403,0,2,201,4668
"3216",2023-10-25,10,41,0,3811,0,4,166,4032
"3217",2023-10-26,9,38,0,3520,0,1,142,3710
"3218",2023-10-27,18,33,0,2199,0,1,125,2376
"3219",2023-10-28,10,12,0,1243,0,0,72,1337
"3220",2023-10-29,13,19,0,1318,0,1,67,1418
"3221",2023-10-30,18,46,0,3703,0,3,188,3958
"3222",2023-10-31,15,42,0,3872,0,2,171,4102
"3223",2023-11-01,19,41,0,3876,0,3,182,4121
"3224",2023-11-02,17,44,0,4023,0,2,180,4266
"3225",2023-11-03,11,42,0,2703,0,2,148,2906
"3226",2023-11-04,15,22,0,1026,0,2,74,1139
"3227",2023-11-05,11,20,0,1938,0,2,97,2068
"3228",2023-11-06,18,52,0,4305,0,3,199,4577
"3229",2023-11-07,19,41,0,4693,0,3,187,4943
"3230",2023-11-08,18,42,0,4160,0,3,175,4398
"3231",2023-11-09,23,42,0,3724,0,3,151,3943
"3232",2023-11-10,13,29,0,2133,0,2,121,2298
"3233",2023-11-11,0,0,0,0,0,0,0,0
"3234",2023-11-12,17,23,0,1736,0,2,75,1853
"3235",2023-11-13,16,50,0,4067,0,6,182,4321
"3236",2023-11-14,21,40,0,4214,0,3,173,4451
"3237",2023-11-15,17,49,0,3968,0,2,173,4209
"3238",2023-11-16,25,34,0,3633,0,4,160,3856
"3239",2023-11-17,11,43,0,2546,0,0,134,2734
"3240",2023-11-18,7,21,0,1462,0,2,69,1561
"3241",2023-11-19,10,21,0,1707,0,4,71,1813
"3242",2023-11-20,14,49,0,3375,0,1,179,3618
"3243",2023-11-21,23,40,0,2530,0,3,156,2752
"3244",2023-11-22,24,28,0,1468,0,2,135,1657
"3245",2023-11-23,0,0,0,0,0,0,0,0
"3246",2023-11-24,0,0,0,0,0,0,0,0
"3247",2023-11-25,0,0,0,0,0,0,0,0
"3248",2023-11-26,0,0,0,0,0,0,0,0
"3249",2023-11-27,22,48,0,3942,0,3,203,4218
"3250",2023-11-28,25,41,0,4162,0,5,178,4411
"3251",2023-11-29,14,39,0,3939,0,4,172,4168
"3252",2023-11-30,21,31,0,3389,0,2,158,3601
"3253",2023-12-01,25,31,0,1993,0,4,137,2190
"3254",2023-12-02,17,23,0,1689,0,1,80,1810
"3255",2023-12-03,19,22,0,1641,0,2,84,1768
"3256",2023-12-04,21,44,0,2565,0,4,163,2797
"3257",2023-12-05,22,33,0,2395,0,2,152,2604
"3258",2023-12-06,17,46,0,1949,0,2,149,2163
"3259",2023-12-07,20,37,0,1521,0,3,142,1723
"3260",2023-12-08,19,36,0,868,0,3,133,1059
"3261",2023-12-09,0,0,0,0,0,0,0,0
"3262",2023-12-10,0,0,0,0,0,0,0,0
"3263",2023-12-11,0,0,0,0,0,0,0,0
"3264",2023-12-12,0,0,0,0,0,0,0,0
"3265",2023-12-13,0,0,0,0,0,0,0,0
"3266",2023-12-14,0,0,0,0,0,0,0,0
"3267",2023-12-15,0,0,0,0,0,0,0,0
"3268",2023-12-16,0,0,0,0,0,0,0,0
"3269",2023-12-17,0,0,0,0,0,0,0,0
"3270",2023-12-18,0,0,0,0,0,0,0,0
"3271",2023-12-19,0,0,0,0,0,0,0,0
"3272",2023-12-20,0,0,0,0,0,0,0,0
"3273",2023-12-21,0,0,0,0,0,0,0,0
"3274",2023-12-22,0,0,0,0,0,0,0,0
"3275",2023-12-23,0,0,0,0,0,0,0,0
"3276",2023-12-24,0,0,0,0,0,0,0,0
"3277",2023-12-25,0,0,0,0,0,0,0,0
"3278",2023-12-26,0,0,0,0,0,0,0,0
"3279",2023-12-27,0,0,0,0,0,0,0,0
"3280",2023-12-28,0,0,0,0,0,0,0,0
"3281",2023-12-29,0,0,0,0,0,0,0,0
"3282",2023-12-30,0,0,0,0,0,0,0,0
"3283",2023-12-31,0,0,0,0,0,0,0,0
"3284",2024-01-01,0,0,0,0,0,0,0,0
"3285",2024-01-02,13,17,0,226,0,1,53,310
"3286",2024-01-03,12,18,0,316,0,1,65,412
"3287",2024-01-04,17,18,0,377,0,2,73,487
"3288",2024-01-05,14,23,0,500,0,2,85,624
"3289",2024-01-06,0,0,0,0,0,0,0,0
"3290",2024-01-07,0,0,0,0,0,0,0,0
"3291",2024-01-08,14,42,0,5574,0,2,183,5815
"3292",2024-01-09,24,39,0,5774,0,4,187,6028
"3293",2024-01-10,15,31,0,5329,0,3,187,5565
"3294",2024-01-11,20,31,0,4829,0,3,179,5062
"3295",2024-01-12,14,25,0,3212,0,4,156,3411
"3296",2024-01-13,10,9,0,1537,0,1,50,1607
"3297",2024-01-14,0,0,0,0,0,0,0,0
"3298",2024-01-15,0,0,0,0,0,0,0,0
"3299",2024-01-16,1,8,0,1826,0,1,30,1866
"3300",2024-01-17,3,9,0,2104,0,1,42,2159
"3301",2024-01-18,27,31,0,5108,0,3,169,5338
"3302",2024-01-19,13,46,0,3665,0,8,154,3886
"3303",2024-01-20,16,24,0,2176,0,2,93,2311
"3304",2024-01-21,13,19,0,2227,0,3,81,2343
"3305",2024-01-22,19,51,0,5867,0,3,223,6163
"3306",2024-01-23,23,42,0,5647,0,6,247,5965
"3307",2024-01-24,12,41,0,5341,0,4,209,5607
"3308",2024-01-25,11,46,0,4810,0,3,207,5077
"3309",2024-01-26,14,35,0,3141,0,8,169,3367
"3310",2024-01-27,19,26,0,1901,0,1,90,2037
"3311",2024-01-28,7,17,0,2077,0,1,80,2182
"3312",2024-01-29,21,46,0,5355,0,5,247,5674
"3313",2024-01-30,15,31,0,5482,0,5,205,5738
"3314",2024-01-31,17,42,0,5339,0,6,216,5620
"3315",2024-02-01,12,31,0,4798,0,7,194,5042
"3316",2024-02-02,13,38,0,3070,0,5,159,3285
"3317",2024-02-03,12,18,0,1890,0,1,76,1997
"3318",2024-02-04,10,21,0,2176,0,1,92,2300
"3319",2024-02-05,22,43,0,5143,0,5,223,5436
"3320",2024-02-06,16,39,0,5296,0,8,219,5578
"3321",2024-02-07,20,47,0,5162,0,4,211,5444
"3322",2024-02-08,21,33,0,4397,0,5,193,4649
"3323",2024-02-09,19,39,0,2880,0,10,148,3096
"3324",2024-02-10,8,13,0,1978,0,2,81,2082
"3325",2024-02-11,12,22,0,1162,0,1,72,1269
"3326",2024-02-12,22,48,0,4790,0,4,221,5085
"3327",2024-02-13,17,33,0,5085,0,5,209,5349
"3328",2024-02-14,13,31,0,4345,0,5,204,4598
"3329",2024-02-15,20,44,0,4237,0,6,174,4481
"3330",2024-02-16,11,33,0,2787,0,3,163,2997
"3331",2024-02-17,16,28,0,1826,0,1,82,1953
"3332",2024-02-18,14,21,0,1994,0,1,78,2108
"3333",2024-02-19,15,42,0,4764,0,4,228,5053
"3334",2024-02-20,19,40,0,5337,0,3,206,5605
"3335",2024-02-21,17,47,0,5259,0,6,191,5520
"3336",2024-02-22,17,34,0,4574,0,6,184,4815
"3337",2024-02-23,9,31,0,2726,0,4,127,2897
"3338",2024-02-24,12,25,0,1619,0,1,62,1719
"3339",2024-02-25,12,20,0,2195,0,0,74,2301
"3340",2024-02-26,13,45,0,5149,0,4,217,5428
"3341",2024-02-27,17,46,0,5361,0,1,194,5619
"3342",2024-02-28,14,35,0,4841,0,5,188,5083
"3343",2024-02-29,19,37,0,4570,0,4,162,4792
"3344",2024-03-01,12,25,0,2942,0,3,134,3116
"3345",2024-03-02,13,29,0,1970,0,2,81,2095
"3346",2024-03-03,6,22,0,2159,0,3,76,2266
"3347",2024-03-04,14,39,0,4963,0,2,204,5222
"3348",2024-03-05,15,40,0,4886,0,4,194,5139
"3349",2024-03-06,14,37,0,4707,0,6,180,4944
"3350",2024-03-07,15,34,0,4252,0,4,172,4477
"3351",2024-03-08,12,28,0,2793,0,6,126,2965
"3352",2024-03-09,10,15,0,1825,0,12,78,1940
"3353",2024-03-10,17,19,0,1727,0,4,77,1844
"3354",2024-03-11,19,46,0,4484,0,5,207,4761
"3355",2024-03-12,13,39,0,4677,0,4,166,4899
"3356",2024-03-13,11,33,0,4403,0,5,165,4617
"3357",2024-03-14,11,29,0,3761,0,1,162,3964
"3358",2024-03-15,15,31,0,2507,0,5,104,2662
"3359",2024-03-16,7,17,0,1202,0,3,54,1283
"3360",2024-03-17,13,18,0,1399,0,3,52,1485
"3361",2024-03-18,9,31,0,2294,0,2,147,2483
"3362",2024-03-19,17,35,0,2248,0,1,145,2446
"3363",2024-03-20,14,37,0,1806,0,1,134,1992
"3364",2024-03-21,17,26,0,1240,0,2,127,1412
"3365",2024-03-22,13,19,0,749,0,0,100,881
"3366",2024-03-23,0,0,0,0,0,0,0,0
"3367",2024-03-24,0,0,0,0,0,0,0,0
"3368",2024-03-25,0,0,0,1,0,3,0,4
"3369",2024-03-26,12,21,0,450,0,1,57,541
"3370",2024-03-27,7,22,0,441,0,1,74,545
"3371",2024-03-28,11,15,0,435,0,3,71,535
"3372",2024-03-29,8,20,0,374,0,1,66,469
"3373",2024-03-30,0,0,0,0,0,0,0,0
"3374",2024-03-31,0,0,0,0,0,0,0,0
"3375",2024-04-01,12,44,0,4952,0,3,168,5179
"3376",2024-04-02,8,39,0,5214,0,2,181,5444
"3377",2024-04-03,13,37,0,5047,0,6,168,5271
"3378",2024-04-04,17,35,0,4863,0,4,165,5084
"3379",2024-04-05,22,26,0,3101,0,4,146,3299
"3380",2024-04-06,15,22,0,2056,0,0,71,2164
"3381",2024-04-07,13,20,0,2125,0,1,85,2244
"3382",2024-04-08,11,36,0,5243,0,6,202,5498
"3383",2024-04-09,19,40,0,5267,0,3,207,5536
"3384",2024-04-10,12,33,0,4886,0,5,184,5120
"3385",2024-04-11,11,37,0,4572,0,9,195,4824
"3386",2024-04-12,19,28,0,3005,0,3,144,3199
"3387",2024-04-13,14,18,0,1719,0,0,77,1828
"3388",2024-04-14,4,20,0,1838,0,0,71,1933
"3389",2024-04-15,17,44,0,4821,0,5,208,5095
"3390",2024-04-16,19,42,0,4902,0,4,207,5174
"3391",2024-04-17,12,38,0,4597,0,6,202,4855
"3392",2024-04-18,8,26,0,4136,0,4,176,4350
"3393",2024-04-19,7,31,0,2233,0,1,124,2396
"3394",2024-04-20,5,22,0,1359,0,0,60,1446
"3395",2024-04-21,14,14,0,1635,0,4,75,1742
"3396",2024-04-22,11,40,0,4383,0,4,178,4616
"3397",2024-04-23,11,42,0,4590,0,6,202,4851
"3398",2024-04-24,10,29,0,4170,0,5,170,4384
"3399",2024-04-25,7,30,0,3812,0,3,169,4021
"3400",2024-04-26,16,29,0,2620,0,4,129,2798
"3401",2024-04-27,7,10,0,195,0,0,19,231
"3402",2024-04-28,10,20,0,1662,0,2,80,1774
"3403",2024-04-29,16,39,0,4326,0,7,194,4582
"3404",2024-04-30,25,41,0,4501,0,6,200,4773
"3405",2024-05-01,11,34,0,4239,0,6,160,4450
"3406",2024-05-02,17,37,0,3868,0,6,176,4104
"3407",2024-05-03,11,25,0,2419,0,2,113,2570
"3408",2024-05-04,15,25,0,1722,0,2,75,1839
"3409",2024-05-05,11,13,0,1746,0,4,84,1858
"3410",2024-05-06,19,41,0,4318,0,4,198,4580
"3411",2024-05-07,14,33,0,4643,0,5,200,4895
"3412",2024-05-08,13,39,0,4049,0,5,181,4287
"3413",2024-05-09,9,29,0,3533,0,4,197,3772
"3414",2024-05-10,14,38,0,2000,0,3,132,2187
"3415",2024-05-11,9,15,0,973,0,1,46,1044
"3416",2024-05-12,11,12,0,1166,0,0,57,1246
"3417",2024-05-13,9,46,0,4249,0,7,176,4487
"3418",2024-05-14,13,41,0,4536,0,3,199,4792
"3419",2024-05-15,11,33,0,4034,0,4,181,4263
"3420",2024-05-16,15,26,0,3705,0,5,172,3923
"3421",2024-05-17,20,21,0,2243,0,2,123,2409
"3422",2024-05-18,9,20,0,1428,0,3,59,1519
"3423",2024-05-19,11,17,0,1338,0,2,77,1445
"3424",2024-05-20,12,41,0,4140,0,8,203,4404
"3425",2024-05-21,24,48,0,4349,0,4,202,4627
"3426",2024-05-22,17,32,0,4026,0,6,190,4271
"3427",2024-05-23,12,26,0,3366,0,1,173,3578
"3428",2024-05-24,15,18,0,2205,0,0,137,2375
"3429",2024-05-25,12,18,0,1267,0,0,58,1355
"3430",2024-05-26,16,16,0,1243,0,1,58,1334
"3431",2024-05-27,0,0,0,0,0,0,0,0
"3432",2024-05-28,25,40,0,4191,0,4,185,4445
"3433",2024-05-29,10,37,0,4207,0,4,179,4437
"3434",2024-05-30,15,30,0,3733,0,3,158,3939
"3435",2024-05-31,14,28,0,2220,0,3,128,2393
"3436",2024-06-01,7,18,0,1320,0,2,68,1415
"3437",2024-06-02,14,21,0,1500,0,3,87,1625
"3438",2024-06-03,20,37,0,4139,0,7,173,4376
"3439",2024-06-04,17,33,0,3986,0,4,189,4229
"3440",2024-06-05,10,20,0,2403,0,2,92,2527
"3441",2024-06-06,25,31,0,3286,0,2,172,3516
"3442",2024-06-07,15,24,0,1887,0,2,109,2037
"3443",2024-06-08,16,16,0,1195,0,2,57,1286
"3444",2024-06-09,12,8,0,1148,0,1,70,1239
"3445",2024-06-10,12,27,0,1941,0,3,158,2141
"3446",2024-06-11,18,28,0,1965,0,3,162,2176
"3447",2024-06-12,18,33,0,1451,0,2,132,1636
"3448",2024-06-13,16,24,0,1143,0,0,130,1313
"3449",2024-06-14,16,28,0,670,0,2,91,807
"3450",2024-06-15,0,0,0,0,0,0,0,0
"3451",2024-06-16,0,0,0,0,0,0,0,0
"3452",2024-06-17,14,20,0,238,0,1,61,334
"3453",2024-06-18,11,19,0,280,0,0,68,378
"3454",2024-06-19,0,0,0,0,0,0,0,0
"3455",2024-06-20,25,17,0,108,0,4,155,309
"3456",2024-06-21,16,11,0,113,0,6,142,288
"3457",2024-06-22,0,0,0,0,0,0,0,0
"3458",2024-06-23,0,0,0,0,0,0,0,0
"3459",2024-06-24,31,29,0,248,0,17,246,571
"3460",2024-06-25,26,24,0,203,0,20,243,516
"3461",2024-06-26,21,12,0,212,0,17,227,489
"3462",2024-06-27,28,24,0,152,0,8,199,411
"3463",2024-06-28,18,15,0,157,0,10,192,392
"3464",2024-06-29,7,7,0,69,0,2,53,138
"3465",2024-06-30,0,0,0,0,0,0,0,0
"3466",2024-07-01,30,31,0,251,0,11,282,605
"3467",2024-07-02,23,20,0,225,0,10,251,529
"3468",2024-07-03,23,19,0,234,0,13,255,544
"3469",2024-07-04,0,0,0,0,0,0,0,0
"3470",2024-07-05,29,21,0,165,0,5,189,409
"3471",2024-07-06,12,10,0,82,0,5,95,204
"3472",2024-07-07,0,0,0,0,0,0,0,0
"3473",2024-07-08,43,34,0,297,0,12,320,706
"3474",2024-07-09,35,22,0,265,0,15,291,628
"3475",2024-07-10,31,23,0,257,0,14,258,583
"3476",2024-07-11,30,23,0,215,0,14,263,545
"3477",2024-07-12,12,20,0,191,0,11,235,469
"3478",2024-07-13,11,12,0,91,0,3,98,215
"3479",2024-07-14,0,0,0,0,0,0,0,0
"3480",2024-07-15,40,24,0,298,0,12,297,671
"3481",2024-07-16,40,23,0,285,0,16,270,634
"3482",2024-07-17,27,25,0,262,0,13,264,591
"3483",2024-07-18,24,19,0,211,0,12,200,466
"3484",2024-07-19,34,20,0,190,0,7,216,467
"3485",2024-07-20,8,11,0,98,0,4,94,215
"3486",2024-07-21,0,0,0,0,0,0,0,0
"3487",2024-07-22,31,29,0,273,0,17,278,628
"3488",2024-07-23,17,21,0,306,0,16,265,625
"3489",2024-07-24,22,17,0,240,0,16,241,536
"3490",2024-07-25,21,23,0,220,0,8,227,499
"3491",2024-07-26,14,17,0,176,0,10,203,420
"3492",2024-07-27,7,10,0,92,0,3,94,206
"3493",2024-07-28,0,0,0,0,0,0,0,0
"3494",2024-07-29,41,25,0,302,0,9,277,654
"3495",2024-07-30,19,20,0,289,0,13,277,618
"3496",2024-07-31,29,22,0,235,0,9,256,551
"3497",2024-08-01,30,21,0,221,0,10,220,502
"3498",2024-08-02,20,17,0,189,0,4,194,424
"3499",2024-08-03,7,12,0,85,0,1,87,192
"3500",2024-08-04,0,0,0,0,0,0,0,0
"3501",2024-08-05,26,27,0,288,0,9,292,642
"3502",2024-08-06,21,27,0,257,0,11,246,562
"3503",2024-08-07,16,17,0,228,0,9,215,485
"3504",2024-08-08,26,24,0,244,0,16,234,544
"3505",2024-08-09,19,21,0,193,0,3,210,446
"3506",2024-08-10,9,7,0,75,0,4,89,184
"3507",2024-08-11,0,0,0,0,0,0,0,0
"3508",2024-08-12,28,28,0,269,0,9,268,602
"3509",2024-08-13,18,29,0,223,0,9,279,558
"3510",2024-08-14,20,21,0,201,0,5,262,509
"3511",2024-08-15,14,22,0,190,0,14,228,468
"3512",2024-08-16,20,18,0,172,0,12,205,427
"3513",2024-08-17,7,8,0,66,0,7,89,177
"3514",2024-08-18,0,0,0,0,0,0,0,0
"3515",2024-08-19,17,33,0,246,0,15,308,619
"3516",2024-08-20,21,18,0,237,0,10,262,548
"3517",2024-08-21,20,28,0,208,0,6,273,535
"3518",2024-08-22,18,26,0,200,0,8,211,463
"3519",2024-08-23,23,21,0,158,0,6,191,399
"3520",2024-08-24,9,9,0,95,0,3,87,203
"3521",2024-08-25,0,0,0,0,0,0,0,0
"3522",2024-08-26,24,29,0,249,0,9,276,587
"3523",2024-08-27,23,21,0,210,0,5,246,505
"3524",2024-08-28,20,23,0,180,0,5,230,458
"3525",2024-08-29,17,18,0,172,0,10,207,424
"3526",2024-08-30,20,24,0,150,0,5,189,388
"3527",2024-08-31,0,0,0,0,0,0,0,0
"3528",2024-09-01,0,0,0,0,0,0,0,0
"3529",2024-09-02,0,0,0,0,0,0,0,0
"3530",2024-09-03,0,0,0,0,0,0,0,0
"3531",2024-09-04,0,0,0,0,0,0,0,0
"3532",2024-09-05,0,0,0,0,0,0,0,0
"3533",2024-09-06,0,0,0,0,0,0,0,0
"3534",2024-09-07,0,0,0,0,0,0,0,0
"3535",2024-09-08,0,0,0,0,0,0,0,0
"3536",2024-09-09,0,0,0,0,0,0,0,0
"3537",2024-09-10,0,0,0,0,0,0,0,0
"3538",2024-09-11,0,0,0,0,0,0,0,0
"3539",2024-09-12,0,0,0,0,0,0,0,0
"3540",2024-09-13,0,0,0,0,0,0,0,0
"3541",2024-09-14,0,0,0,0,0,0,0,0
"3542",2024-09-15,0,0,0,0,0,0,0,0
"3543",2024-09-16,22,22,0,227,0,9,245,525
"3544",2024-09-17,18,23,0,231,0,10,243,525
"3545",2024-09-18,10,18,0,756,0,11,222,1017
"3546",2024-09-19,4,19,0,697,0,10,209,939
"3547",2024-09-20,12,19,0,730,0,8,174,943
"3548",2024-09-21,0,0,0,0,0,0,0,0
"3549",2024-09-22,0,0,0,0,0,0,0,0
"3550",2024-09-23,14,29,0,1705,0,4,97,1849
"3551",2024-09-24,12,26,0,1640,0,2,93,1773
"3552",2024-09-25,13,32,0,1780,0,2,92,1919
"3553",2024-09-26,10,18,0,1927,0,4,68,2027
"3554",2024-09-27,12,21,0,2440,0,1,78,2552
"3555",2024-09-28,2,8,0,2041,0,0,20,2071
"3556",2024-09-29,12,7,0,1594,0,0,25,1638
"3557",2024-09-30,18,34,0,6086,0,2,162,6302
"3558",2024-10-01,15,27,0,5790,0,5,163,6000
"3559",2024-10-02,20,30,0,5220,0,3,147,5420
"3560",2024-10-03,18,23,0,4429,0,3,144,4617
"3561",2024-10-04,10,17,0,1731,0,1,77,1836
"3562",2024-10-05,11,17,0,2145,0,0,57,2230
"3563",2024-10-06,8,15,0,1956,0,0,50,2029
"3564",2024-10-07,16,30,0,5330,0,0,163,5539
"3565",2024-10-08,16,34,0,5258,0,6,169,5483
"3566",2024-10-09,12,26,0,4273,0,1,141,4453
"3567",2024-10-10,18,29,0,3858,0,4,136,4045
"3568",2024-10-11,13,17,0,2786,0,0,113,2929
"3569",2024-10-12,6,9,0,421,0,0,31,467
"3570",2024-10-13,7,12,0,1569,0,0,56,1644
"3571",2024-10-14,14,27,0,4428,0,2,163,4634
"3572",2024-10-15,10,20,0,4303,0,2,166,4501
"3573",2024-10-16,19,32,0,4053,0,3,146,4253
"3574",2024-10-17,19,27,0,3783,0,3,157,3989
"3575",2024-10-18,10,26,0,2236,0,2,110,2384
"3576",2024-10-19,5,21,0,1668,0,1,47,1742
"3577",2024-10-20,8,14,0,1752,0,0,55,1829
"3578",2024-10-21,18,33,0,4477,0,6,167,4701
"3579",2024-10-22,14,31,0,4266,0,5,148,4464
"3580",2024-10-23,10,31,0,3973,0,5,147,4166
"3581",2024-10-24,19,27,0,3540,0,4,146,3736
"3582",2024-10-25,9,25,0,2154,0,1,113,2302
"3583",2024-10-26,2,10,0,262,0,0,23,297
"3584",2024-10-27,8,17,0,1806,0,2,64,1897
"3585",2024-10-28,18,40,0,4576,0,4,162,4800
"3586",2024-10-29,14,33,0,4506,0,6,170,4729
"3587",2024-10-30,9,33,0,3941,0,1,129,4113
"3588",2024-10-31,16,26,0,2995,0,7,129,3173
"3589",2024-11-01,9,27,0,1939,0,1,92,2068
"3590",2024-11-02,6,19,0,1367,0,1,52,1445
"3591",2024-11-03,12,20,0,1696,0,1,63,1792
"3592",2024-11-04,15,38,0,4342,0,2,151,4548
"3593",2024-11-05,13,32,0,4326,0,8,162,4541
"3594",2024-11-06,20,32,0,4254,0,1,144,4451
"3595",2024-11-07,22,26,0,3750,0,3,148,3949
"3596",2024-11-08,12,22,0,2626,0,1,115,2776
"3597",2024-11-09,1,12,0,662,0,0,34,709
"3598",2024-11-10,16,20,0,1914,0,4,84,2038
"3599",2024-11-11,0,0,0,0,0,0,0,0
"3600",2024-11-12,20,39,0,4728,0,2,163,4952
"3601",2024-11-13,24,30,0,4458,0,0,150,4662
"3602",2024-11-14,15,31,0,4009,0,5,142,4202
"3603",2024-11-15,20,36,0,2593,0,1,115,2765
"3604",2024-11-16,8,15,0,1753,0,1,50,1827
"3605",2024-11-17,19,21,0,1874,0,1,65,1980
"3606",2024-11-18,16,42,0,4378,0,2,160,4598
"3607",2024-11-19,15,36,0,4563,0,2,168,4784
"3608",2024-11-20,17,35,0,4133,0,1,138,4324
"3609",2024-11-21,16,34,0,3873,0,6,154,4083
"3610",2024-11-22,20,38,0,2769,0,2,128,2957
"3611",2024-11-23,13,20,0,1878,0,1,75,1987
"3612",2024-11-24,10,18,0,1699,0,1,60,1788
"3613",2024-11-25,21,38,0,3618,0,2,136,3815
"3614",2024-11-26,10,29,0,2427,0,1,133,2600
"3615",2024-11-27,12,24,0,1331,0,1,107,1475
"3616",2024-11-28,0,0,0,0,0,0,0,0
"3617",2024-11-29,0,0,0,0,0,0,0,0
"3618",2024-11-30,0,0,0,0,0,0,0,0
"3619",2024-12-01,0,0,0,0,0,0,0,0
"3620",2024-12-02,24,40,0,3871,0,1,154,4090
"3621",2024-12-03,19,34,0,3974,0,5,139,4171
"3622",2024-12-04,12,31,0,3777,0,4,133,3957
"3623",2024-12-05,17,23,0,3228,0,6,129,3403
"3624",2024-12-06,9,15,0,2223,0,3,112,2362
"3625",2024-12-07,8,12,0,1235,0,0,53,1308
"3626",2024-12-08,6,12,0,1339,0,1,54,1412
"3627",2024-12-09,13,27,0,1994,0,1,113,2148
"3628",2024-12-10,16,25,0,1993,0,2,134,2170
"3629",2024-12-11,13,25,0,1542,0,2,120,1702
"3630",2024-12-12,14,23,0,1111,0,1,104,1253
"3631",2024-12-13,21,21,0,595,0,1,98,736
"3632",2024-12-14,0,0,0,0,0,0,0,0
"3633",2024-12-15,0,0,0,0,0,0,0,0
