"date","nonmembers","faculty_staff","community_members","alumni","students","pe_staff","student_offterm","other","total"
2015-01-05,7,2,22,34,6796,79,0,0,6940
2015-01-06,10,2,35,29,6181,447,0,0,6704
2015-01-07,15,68,45,34,5843,204,0,0,6209
2015-01-08,9,1,46,25,5097,19,0,0,5197
2015-01-09,13,0,45,30,4219,117,0,0,4424
2015-01-10,8,0,30,19,2715,3,0,0,2775
2015-01-11,8,0,40,19,2843,6,0,0,2916
2015-01-12,5,0,23,27,2980,22,0,0,3057
2015-01-13,8,6,42,28,4988,41,0,0,5113
2015-01-14,9,0,44,39,5606,25,0,1,5724
2015-01-15,14,0,45,28,5046,18,0,1,5152
2015-01-16,13,1,61,34,3496,12,0,0,3617
2015-01-17,6,0,29,19,2441,1,0,0,2496
2015-01-18,3,1,26,22,2174,1,0,0,2227
2015-01-19,10,0,32,26,2526,1,0,0,2595
2015-01-20,14,1,63,44,5376,19,0,2,5519
2015-01-21,9,0,55,46,5322,18,0,2,5452
2015-01-22,7,0,54,33,5278,16,0,2,5390
2015-01-23,12,0,47,28,4062,9,0,2,4160
2015-01-24,2,0,36,26,2551,1,0,0,2616
2015-01-25,6,0,35,14,2216,3,0,0,2274
2015-01-26,14,0,58,44,5153,16,0,4,5289
2015-01-27,6,0,70,45,4831,14,0,2,4968
2015-01-28,11,0,67,39,5005,14,0,5,5141
2015-01-29,12,0,57,33,4782,9,0,2,4895
2015-01-30,11,0,55,37,3441,7,0,1,3552
2015-01-31,8,0,39,22,2348,1,0,0,2418
2015-02-01,5,0,26,21,1670,3,0,0,1725
2015-02-02,15,0,68,42,5172,17,0,4,5318
2015-02-03,10,0,54,40,4974,21,0,3,5102
2015-02-04,8,0,60,30,4963,14,0,2,5077
2015-02-05,11,0,65,27,4672,16,0,2,4793
2015-02-06,9,0,50,44,3476,11,0,2,3592
2015-02-07,5,0,45,20,2484,2,0,0,2556
2015-02-08,13,0,39,30,2078,1,0,0,2161
2015-02-09,9,0,63,50,4916,9,0,1,5048
2015-02-10,8,0,62,40,5086,6,0,3,5205
2015-02-11,6,1,65,46,5066,16,0,4,5204
2015-02-12,12,0,65,37,4615,7,0,3,4739
2015-02-13,12,0,44,33,3158,36,0,0,3283
2015-02-14,3,0,29,28,1716,5,0,0,1781
2015-02-15,5,0,29,23,1810,1,0,0,1868
2015-02-16,9,0,72,41,5059,16,0,3,5200
2015-02-17,1,0,61,44,4745,11,0,2,4864
2015-02-18,6,1,67,38,4575,273,0,4,4964
2015-02-19,6,0,62,32,4296,12,0,2,4410
2015-02-20,11,0,57,33,3060,4,0,1,3166
2015-02-21,3,0,43,27,1952,1,0,0,2026
2015-02-22,4,0,32,22,2081,0,0,0,2139
2015-02-23,12,0,70,37,4881,8,0,1,5009
2015-02-24,5,0,70,42,4807,9,0,3,4936
2015-02-25,5,0,74,46,4335,7,0,2,4469
2015-02-26,4,0,71,42,4306,9,0,1,4433
2015-02-27,7,1,51,26,3092,5,0,1,3183
2015-02-28,4,0,39,23,2161,1,0,0,2228
2015-03-01,4,0,37,23,2063,0,0,0,2127
2015-03-02,16,0,58,48,4764,69,0,2,4957
2015-03-03,6,0,66,38,4335,7,0,2,4454
2015-03-04,5,0,63,41,4373,6,0,2,4490
2015-03-05,4,0,67,32,4218,3,0,4,4328
2015-03-06,6,0,39,35,2954,7,0,2,3043
2015-03-07,6,0,36,16,2047,0,0,0,2105
2015-03-08,4,0,40,21,1986,0,0,0,2051
2015-03-09,8,0,64,30,4741,8,0,4,4855
2015-03-10,8,0,62,39,4463,4,0,3,4579
2015-03-11,8,0,55,38,4382,7,0,4,4494
2015-03-12,6,0,43,27,3976,28,0,1,4081
2015-03-13,8,0,47,33,3060,1,0,3,3152
2015-03-14,1,0,34,16,2243,3,0,0,2297
2015-03-15,3,0,40,32,2313,3,0,0,2391
2015-03-16,12,0,57,31,2827,3,0,3,2933
2015-03-17,7,0,44,34,2527,7,0,0,2619
2015-03-18,11,0,35,30,2095,6,0,0,2177
2015-03-19,5,0,21,22,1196,7,0,0,1251
2015-03-20,5,0,27,25,858,2,0,1,918
2015-03-21,0,0,0,0,0,0,0,0,0
2015-03-22,0,0,0,0,0,0,0,0,0
2015-03-23,8,0,31,22,723,7,0,2,793
2015-03-24,6,0,22,26,696,2,0,0,752
2015-03-25,5,0,14,24,636,6,0,0,685
2015-03-26,1,0,17,17,573,4,0,0,612
2015-03-27,10,0,17,22,590,5,0,0,644
2015-03-28,0,0,0,0,0,1,0,0,1
2015-03-29,0,0,10,11,876,1,0,0,898
2015-03-30,11,0,54,31,5512,16,0,0,5624
2015-03-31,14,0,54,32,5654,17,0,1,5772
2015-04-01,11,0,55,38,5399,5,0,0,5508
2015-04-02,9,0,50,32,4959,5,0,1,5056
2015-04-03,13,0,52,30,3043,2,0,1,3141
2015-04-04,5,0,33,16,2017,1,0,0,2072
2015-04-05,2,0,37,26,2060,3,0,0,2128
2015-04-06,7,0,86,38,5525,16,0,1,5673
2015-04-07,15,0,70,42,5701,16,0,1,5845
2015-04-08,3,0,74,37,5712,10,0,0,5836
2015-04-09,10,0,70,29,5087,5,0,3,5204
2015-04-10,11,0,44,31,3379,3,0,2,3470
2015-04-11,5,0,36,18,2242,1,0,0,2302
2015-04-12,3,0,32,22,2099,0,0,0,2156
2015-04-13,7,0,71,36,5138,11,0,1,5264
2015-04-14,25,0,65,42,5493,10,0,2,5637
2015-04-15,6,0,74,30,5075,13,0,0,5198
2015-04-16,11,0,48,25,4640,11,0,3,4738
2015-04-17,11,0,42,26,2941,6,0,2,3028
2015-04-18,2,0,20,11,1888,2,0,0,1923
2015-04-19,6,0,31,14,1902,2,0,0,1955
2015-04-20,7,0,56,40,4439,13,0,1,4556
2015-04-21,21,0,71,30,4899,9,0,3,5033
2015-04-22,10,1,73,41,4638,10,0,0,4773
2015-04-23,15,0,63,31,4495,7,0,6,4617
2015-04-24,14,0,37,30,3174,6,0,3,3264
2015-04-25,6,0,47,17,2306,3,0,0,2379
2015-04-26,3,0,38,22,2097,1,0,0,2161
2015-04-27,5,0,69,46,4771,7,0,1,4899
2015-04-28,20,0,63,34,4859,12,0,3,4991
2015-04-29,8,0,63,35,4696,11,0,0,4813
2015-04-30,7,0,64,38,4307,7,0,3,4426
2015-05-01,13,0,44,31,2731,2,0,1,2822
2015-05-02,4,0,22,13,1344,0,0,0,1383
2015-05-03,2,0,38,16,2064,0,0,0,2120
2015-05-04,7,0,65,45,4653,8,0,1,4779
2015-05-05,11,0,62,31,4589,5,0,4,4702
2015-05-06,9,0,65,36,4303,6,0,0,4419
2015-05-07,9,0,60,33,4392,7,0,4,4505
2015-05-08,12,0,44,23,2664,4,0,3,2750
2015-05-09,3,0,25,11,1657,2,0,0,1698
2015-05-10,6,0,34,14,1894,4,0,0,1952
2015-05-11,10,0,70,42,4297,11,0,2,4432
2015-05-12,13,0,68,29,4539,7,0,3,4659
2015-05-13,13,0,62,37,4222,8,0,1,4343
2015-05-14,8,0,68,27,3901,12,0,4,4020
2015-05-15,9,0,41,23,2531,2,0,0,2606
2015-05-16,3,0,23,24,1745,3,0,0,1798
2015-05-17,5,0,26,19,1833,1,0,0,1884
2015-05-18,6,0,69,48,4452,9,0,1,4585
2015-05-19,8,0,74,34,4377,6,0,3,4502
2015-05-20,8,0,72,30,4184,57,0,1,4352
2015-05-21,4,0,62,29,3777,9,0,3,3884
2015-05-22,9,0,42,21,2294,4,0,3,2373
2015-05-23,1,0,31,14,1390,0,0,0,1436
2015-05-24,4,0,35,15,1433,2,0,0,1489
2015-05-25,3,0,34,21,1479,1,0,0,1538
2015-05-26,11,0,58,29,3990,12,0,2,4102
2015-05-27,5,0,69,35,4136,8,0,3,4256
2015-05-28,7,0,49,33,3740,16,0,4,3849
2015-05-29,15,0,43,28,2581,9,0,2,2678
2015-05-30,4,0,22,21,1658,0,0,0,1705
2015-05-31,12,0,34,15,1784,2,0,0,1847
2015-06-01,7,0,55,37,3925,9,0,1,4034
2015-06-02,16,0,64,31,3841,7,0,4,3963
2015-06-03,10,0,68,28,3715,11,0,1,3833
2015-06-04,8,0,39,29,3294,8,0,3,3381
2015-06-05,12,0,48,32,2238,5,0,6,2341
2015-06-06,5,0,27,17,1411,1,0,0,1461
2015-06-07,9,0,23,14,1436,1,0,0,1483
2015-06-08,12,0,40,34,2228,5,0,2,2321
2015-06-09,10,0,39,35,2028,7,0,0,2119
2015-06-10,4,0,35,30,1701,2,0,0,1772
2015-06-11,11,0,24,14,926,1,0,0,976
2015-06-12,3,0,31,24,875,3,0,0,936
2015-06-13,2,0,13,14,616,1,0,0,646
2015-06-14,4,0,15,16,544,2,0,0,581
2015-06-15,0,0,0,0,7,0,0,0,7
2015-06-16,9,0,23,22,622,2,0,0,678
2015-06-17,7,0,16,14,652,2,0,0,691
2015-06-18,7,0,29,16,638,3,0,0,693
2015-06-19,9,0,19,16,589,3,0,0,636
2015-06-20,0,0,0,0,0,0,0,0,0
2015-06-21,0,0,0,0,0,0,0,0,0
2015-06-22,12,0,21,19,1220,16,0,0,1288
2015-06-23,10,0,21,24,1221,21,0,0,1297
2015-06-24,20,0,16,20,1164,10,0,0,1230
2015-06-25,21,0,19,22,1022,13,0,0,1097
2015-06-26,21,0,20,26,794,9,0,0,870
2015-06-27,12,0,6,14,396,6,0,0,434
2015-06-28,6,0,10,13,455,1,0,0,485
2015-06-29,22,0,31,27,1160,11,0,0,1251
2015-06-30,12,0,25,24,1100,19,0,0,1180
2015-07-01,20,0,19,33,982,14,0,0,1068
2015-07-02,21,0,17,26,928,10,0,0,1002
2015-07-03,0,0,0,0,0,0,0,0,0
2015-07-04,0,0,0,0,0,0,0,0,0
2015-07-05,0,0,0,0,0,0,0,0,0
2015-07-06,23,1,26,30,1122,13,0,0,1215
2015-07-07,14,1,18,33,1116,6,0,0,1188
2015-07-08,21,0,18,29,1045,14,0,0,1127
2015-07-09,13,0,20,28,902,11,0,0,974
2015-07-10,20,0,21,28,827,5,0,0,901
2015-07-11,11,0,9,17,441,1,0,0,479
2015-07-12,6,0,11,18,431,4,0,0,470
2015-07-13,20,0,18,28,1096,10,0,0,1172
2015-07-14,19,0,24,35,1018,7,0,0,1103
2015-07-15,19,0,17,21,965,12,0,0,1034
2015-07-16,18,0,16,17,766,9,0,0,826
2015-07-17,16,0,20,31,709,3,0,0,779
2015-07-18,3,0,12,9,369,0,0,0,393
2015-07-19,7,0,9,11,416,4,0,0,447
2015-07-20,21,0,25,29,1052,3,0,0,1130
2015-07-21,14,0,23,27,1052,6,0,0,1122
2015-07-22,23,0,18,34,1008,10,0,0,1093
2015-07-23,12,0,23,28,893,6,0,0,962
2015-07-24,14,0,22,29,742,2,0,0,809
2015-07-25,5,0,8,16,363,0,0,0,392
2015-07-26,1,0,13,14,379,1,0,0,408
2015-07-27,13,0,27,37,1043,2,0,0,1122
2015-07-28,13,0,30,38,962,14,0,0,1057
2015-07-29,13,0,30,31,969,1,0,0,1044
2015-07-30,16,0,24,26,814,5,0,0,885
2015-07-31,19,0,24,24,715,1,0,0,783
2015-08-01,4,0,10,16,343,2,0,0,375
2015-08-02,4,0,12,15,369,2,0,0,402
2015-08-03,8,0,26,39,957,13,0,0,1043
2015-08-04,6,0,33,34,976,1,0,0,1050
2015-08-05,14,0,24,37,892,5,0,0,972
2015-08-06,5,0,29,26,779,3,0,0,842
2015-08-07,14,0,26,27,656,2,0,0,725
2015-08-08,2,0,14,16,364,0,0,0,396
2015-08-09,8,0,10,17,393,3,0,0,431
2015-08-10,13,0,35,42,844,3,0,0,937
2015-08-11,11,0,31,29,755,7,0,0,833
2015-08-12,3,0,33,32,699,4,0,0,771
2015-08-13,7,0,24,27,551,5,0,0,614
2015-08-14,7,0,26,30,449,4,0,0,516
2015-08-15,1,0,13,14,236,0,0,0,264
2015-08-16,2,0,3,18,280,0,0,0,303
2015-08-17,7,0,31,31,571,1,0,0,641
2015-08-18,12,0,32,30,526,1,0,0,601
2015-08-19,10,0,24,30,569,3,0,0,636
2015-08-20,11,0,19,24,478,3,0,0,535
2015-08-21,8,0,23,27,431,2,0,0,491
2015-08-22,0,0,0,0,0,0,0,0,0
2015-08-23,0,0,0,0,0,0,0,0,0
2015-08-24,0,0,0,0,2,0,0,0,2
2015-08-25,0,0,0,0,0,0,0,0,0
2015-08-26,0,0,0,0,0,0,0,0,0
2015-08-27,0,0,0,0,0,17,0,0,17
2015-08-28,0,0,0,0,0,24,0,0,24
2015-08-29,0,0,0,0,0,0,0,0,0
2015-08-30,0,0,0,0,0,0,0,0,0
2015-08-31,4,0,24,25,501,0,0,0,554
2015-09-01,2,0,16,16,402,1,0,0,437
2015-09-02,7,0,19,19,415,38,0,0,498
2015-09-03,3,0,14,19,375,0,0,0,411
2015-09-04,6,0,14,14,253,0,0,0,287
2015-09-05,0,0,0,0,0,0,0,0,0
2015-09-06,0,0,0,0,0,0,0,0,0
2015-09-07,0,0,0,0,0,0,0,0,0
2015-09-08,10,0,30,32,456,2,0,0,530
2015-09-09,8,0,21,29,432,5,0,0,495
2015-09-10,0,0,17,25,319,3,0,0,364
2015-09-11,5,0,16,21,317,4,0,0,363
2015-09-12,0,0,0,0,0,0,0,0,0
2015-09-13,0,0,0,0,0,0,0,0,0
2015-09-14,6,0,29,26,451,1,0,0,513
2015-09-15,12,0,17,36,434,1,0,0,500
2015-09-16,9,0,30,31,406,7,0,0,483
2015-09-17,7,0,25,23,372,1,0,0,428
2015-09-18,8,0,25,22,458,10,0,0,523
2015-09-19,0,0,0,0,0,0,0,0,0
2015-09-20,0,0,0,0,14,0,0,0,14
2015-09-21,4,0,35,29,1184,23,0,0,1275
2015-09-22,8,0,30,25,1381,7,0,0,1451
2015-09-23,8,0,33,24,1513,9,0,0,1587
2015-09-24,5,0,28,22,2230,21,0,0,2306
2015-09-25,7,0,30,22,2275,4,0,0,2338
2015-09-26,3,0,8,10,1472,2,0,0,1495
2015-09-27,4,0,18,14,2272,0,0,0,2308
2015-09-28,11,0,34,33,6299,17,0,0,6394
2015-09-29,9,0,52,34,5900,12,0,1,6008
2015-09-30,5,0,48,42,5048,7,0,0,5150
2015-10-01,11,0,33,35,4698,3,0,1,4781
2015-10-02,9,0,37,37,3099,1,0,0,3183
2015-10-03,2,0,20,15,1812,0,0,0,1849
2015-10-04,2,0,20,21,1918,0,0,0,1961
2015-10-05,9,0,42,40,4946,8,0,0,5045
2015-10-06,7,0,41,44,4643,6,0,1,4742
2015-10-07,9,1,46,42,4385,6,0,0,4489
2015-10-08,6,0,40,42,4116,5,0,1,4210
2015-10-09,13,0,48,41,2757,0,0,0,2859
2015-10-10,5,0,19,21,1054,2,0,0,1101
2015-10-11,4,0,35,21,1959,0,0,0,2019
2015-10-12,9,1,54,48,4945,10,0,0,5067
2015-10-13,11,1,52,46,4964,10,0,1,5085
2015-10-14,12,0,58,49,4345,6,0,1,4471
2015-10-15,6,0,48,43,4242,4,0,1,4344
2015-10-16,7,0,38,38,2833,4,0,0,2920
2015-10-17,3,0,16,19,1552,1,0,0,1591
2015-10-18,3,0,25,29,1803,1,0,0,1861
2015-10-19,16,0,55,41,4076,7,0,1,4196
2015-10-20,8,0,46,42,4479,9,0,0,4584
2015-10-21,8,0,52,38,4063,7,0,0,4168
2015-10-22,10,0,49,36,3849,5,0,2,3951
2015-10-23,13,0,35,40,2556,3,0,0,2647
2015-10-24,1,0,15,25,1555,0,0,0,1596
2015-10-25,12,0,27,31,1698,2,0,0,1770
2015-10-26,11,0,45,49,4421,7,0,0,4533
2015-10-27,8,0,45,43,4058,10,0,1,4165
2015-10-28,7,0,53,38,3926,10,0,1,4035
2015-10-29,4,0,40,42,3615,7,0,2,3710
2015-10-30,11,0,40,37,2377,0,0,0,2465
2015-10-31,4,0,30,26,1417,0,0,0,1477
2015-11-01,6,0,21,20,1602,1,0,0,1650
2015-11-02,17,0,58,59,4312,7,0,0,4453
2015-11-03,12,0,64,60,4364,7,0,1,4508
2015-11-04,12,0,61,64,4223,11,0,1,4372
2015-11-05,9,0,48,46,3968,5,0,2,4078
2015-11-06,16,0,42,34,2638,6,0,0,2736
2015-11-07,2,0,27,22,1289,0,0,0,1340
2015-11-08,9,0,25,23,1705,0,0,0,1762
2015-11-09,14,0,64,45,4463,4,0,0,4590
2015-11-10,12,0,62,48,4385,7,0,1,4515
2015-11-11,9,0,56,55,4017,6,0,0,4143
2015-11-12,6,0,47,40,3742,4,0,1,3840
2015-11-13,10,0,46,45,2592,2,0,0,2695
2015-11-14,9,0,30,24,1686,1,0,0,1750
2015-11-15,9,0,28,32,1716,1,0,0,1786
2015-11-16,8,1,56,52,3903,4,0,0,4024
2015-11-17,10,0,58,49,4074,4,0,0,4195
2015-11-18,11,0,52,52,4085,5,0,0,4205
2015-11-19,11,0,55,32,3803,5,0,3,3909
2015-11-20,13,0,38,35,2506,4,0,0,2596
2015-11-21,8,0,19,18,1024,0,0,0,1069
2015-11-22,15,0,26,44,1607,0,0,0,1692
2015-11-23,10,0,45,59,3708,4,0,0,3826
2015-11-24,22,0,45,50,3005,4,0,1,3127
2015-11-25,9,0,33,32,1564,2,0,0,1640
2015-11-26,0,0,0,0,0,0,0,0,0
2015-11-27,0,0,0,0,1,0,0,0,1
2015-11-28,0,0,0,0,0,0,0,0,0
2015-11-29,8,0,26,34,1277,0,0,0,1345
2015-11-30,14,0,51,45,3668,5,0,0,3783
2015-12-01,11,1,55,52,3824,6,0,1,3950
2015-12-02,14,0,50,59,3774,5,0,1,3903
2015-12-03,11,0,68,29,3553,5,0,1,3667
2015-12-04,9,0,45,39,2514,1,0,0,2608
2015-12-05,5,0,34,32,1766,1,0,0,1838
2015-12-06,6,0,37,20,1470,0,0,0,1533
2015-12-07,12,1,59,48,2189,2,0,0,2311
2015-12-08,11,0,67,52,2123,3,0,0,2256
2015-12-09,10,0,49,43,1682,0,0,0,1784
2015-12-10,5,0,28,24,992,1,0,0,1050
2015-12-11,8,0,40,33,818,0,0,0,899
2015-12-12,0,0,0,0,0,1,0,0,1
2015-12-13,0,0,0,0,0,0,0,0,0
2015-12-14,16,0,41,37,713,4,0,0,811
2015-12-15,9,1,44,42,598,0,0,0,694
2015-12-16,11,0,33,37,521,1,0,0,603
2015-12-17,13,0,35,30,498,0,0,0,576
2015-12-18,9,0,32,35,452,2,0,0,530
2015-12-19,0,0,0,0,0,0,0,0,0
2015-12-20,0,0,0,0,2,0,0,0,2
2015-12-21,16,0,31,31,397,2,0,0,477
2015-12-22,7,0,30,27,334,1,0,0,399
2015-12-23,13,0,28,29,283,1,0,0,354
2015-12-24,0,0,0,0,0,0,0,0,0
2015-12-25,0,0,0,0,0,0,0,0,0
2015-12-26,0,0,0,0,0,0,0,0,0
2015-12-27,0,0,0,0,0,0,0,0,0
2015-12-28,11,1,35,44,468,1,0,0,560
2015-12-29,7,0,29,25,410,1,0,0,472
2015-12-30,7,0,23,37,394,1,0,0,462
2015-12-31,0,0,0,0,0,0,0,0,0
2016-01-01,0,0,0,0,0,0,0,0,0
2016-01-02,0,0,0,0,0,0,0,0,0
2016-01-03,0,0,17,7,724,1,0,0,749
2016-01-04,16,0,47,54,4878,9,0,0,5004
2016-01-05,15,1,52,49,5208,6,0,0,5331
2016-01-06,22,0,50,56,4774,7,0,0,4909
2016-01-07,12,0,42,51,4578,5,0,0,4688
2016-01-08,17,0,41,43,3224,2,0,0,3327
2016-01-09,11,0,32,32,2173,0,0,0,2248
2016-01-10,13,0,31,29,2038,0,0,0,2111
2016-01-11,14,0,60,62,5138,9,0,0,5283
2016-01-12,20,2,66,61,5257,5,0,0,5411
2016-01-13,12,1,63,68,5005,3,0,0,5152
2016-01-14,14,0,51,55,4670,12,0,0,4802
2016-01-15,14,0,40,42,2841,3,0,0,2940
2016-01-16,10,0,32,27,1812,0,0,0,1881
2016-01-17,8,0,36,33,1813,0,0,0,1890
2016-01-18,11,1,43,49,2205,2,0,0,2311
2016-01-19,13,1,54,49,5127,7,0,2,5253
2016-01-20,17,2,59,68,4998,4,0,0,5148
2016-01-21,10,0,60,50,4599,7,0,1,4727
2016-01-22,20,0,56,46,3210,9,0,0,3341
2016-01-23,3,0,34,31,2173,2,0,0,2243
2016-01-24,11,0,36,39,2375,2,0,0,2463
2016-01-25,11,1,65,61,4871,7,0,0,5016
2016-01-26,12,1,75,59,4888,11,0,1,5047
2016-01-27,9,0,69,54,4897,14,0,0,5043
2016-01-28,11,0,58,50,4535,6,0,1,4661
2016-01-29,16,0,46,44,2921,3,0,0,3030
2016-01-30,8,0,33,26,2140,0,0,0,2207
2016-01-31,7,0,31,34,2393,2,0,0,2467
2016-02-01,15,1,57,59,4950,5,0,0,5087
2016-02-02,11,1,64,43,4922,4,0,1,5046
2016-02-03,11,1,65,59,4630,7,0,0,4773
2016-02-04,13,0,64,37,4356,7,0,1,4478
2016-02-05,13,0,39,52,2790,2,0,0,2896
2016-02-06,3,0,42,29,2208,3,0,0,2285
2016-02-07,4,0,26,22,1371,0,0,0,1423
2016-02-08,17,1,71,58,4781,5,0,0,4933
2016-02-09,11,1,61,48,4747,5,0,1,4874
2016-02-10,12,1,63,57,4654,6,0,0,4793
2016-02-11,10,0,66,45,4102,4,0,0,4227
2016-02-12,13,0,53,47,2670,3,0,0,2786
2016-02-13,9,0,37,23,1822,0,0,0,1891
2016-02-14,10,0,41,28,1879,1,0,0,1959
2016-02-15,17,2,71,54,4610,5,0,0,4759
2016-02-16,12,1,71,52,4770,4,0,1,4911
2016-02-17,9,1,77,50,4532,5,0,0,4674
2016-02-18,12,0,79,37,4046,3,0,1,4178
2016-02-19,10,0,67,44,2823,6,0,0,2950
2016-02-20,3,0,48,31,1867,0,0,0,1949
2016-02-21,7,0,37,34,2073,0,0,0,2151
2016-02-22,18,0,80,50,4757,4,0,0,4909
2016-02-23,8,1,68,49,4709,4,0,1,4840
2016-02-24,6,0,69,54,4213,5,0,0,4347
2016-02-25,5,0,61,38,4065,4,0,1,4174
2016-02-26,8,0,68,46,2730,2,0,0,2854
2016-02-27,3,0,40,38,1990,2,0,0,2073
2016-02-28,12,0,50,23,1942,0,0,0,2027
2016-02-29,11,1,71,54,4610,9,0,0,4756
2016-03-01,12,1,77,48,4584,4,0,1,4727
2016-03-02,10,1,72,51,4296,5,0,0,4435
2016-03-03,9,0,76,44,4187,4,0,1,4321
2016-03-04,4,0,52,38,2701,3,0,0,2798
2016-03-05,5,0,36,37,1758,2,0,0,1838
2016-03-06,12,0,58,24,2054,1,0,0,2149
2016-03-07,10,0,73,62,4513,6,0,0,4664
2016-03-08,10,0,74,44,4134,6,0,0,4268
2016-03-09,15,0,57,49,4085,12,0,0,4218
2016-03-10,6,0,70,47,3980,4,0,1,4108
2016-03-11,11,0,58,38,2576,2,0,0,2685
2016-03-12,6,0,30,34,1857,1,0,0,1928
2016-03-13,10,0,37,34,1855,0,0,0,1936
2016-03-14,8,0,62,51,2542,5,0,0,2668
2016-03-15,13,0,64,50,2320,4,0,0,2451
2016-03-16,19,0,55,53,2026,2,0,0,2155
2016-03-17,5,0,28,32,1016,2,0,0,1083
2016-03-18,5,0,23,19,779,1,0,0,827
2016-03-19,0,0,0,0,0,0,0,0,0
2016-03-20,0,0,0,0,0,0,0,0,0
2016-03-21,6,0,33,42,636,3,0,0,720
2016-03-22,9,0,36,33,494,2,0,0,574
2016-03-23,8,0,26,41,502,1,0,0,578
2016-03-24,6,0,19,24,521,2,0,0,572
2016-03-25,4,0,22,22,526,9,0,0,583
2016-03-26,0,0,0,0,0,0,0,0,0
2016-03-27,2,0,8,13,767,0,0,0,790
2016-03-28,9,0,32,60,5234,12,0,2,5349
2016-03-29,14,0,27,56,5228,7,0,0,5332
2016-03-30,7,0,44,50,5075,9,0,0,5185
2016-03-31,9,0,40,38,4501,6,0,0,4594
2016-04-01,5,0,33,26,2627,2,0,0,2693
2016-04-02,1,0,27,29,1698,1,0,0,1756
2016-04-03,2,0,19,31,2149,1,0,0,2202
2016-04-04,6,0,62,56,5218,8,0,0,5350
2016-04-05,8,0,57,64,5322,4,0,0,5455
2016-04-06,9,0,60,51,4992,7,0,0,5119
2016-04-07,9,0,49,55,4079,3,0,0,4195
2016-04-08,6,0,37,47,2674,0,0,0,2764
2016-04-09,4,0,20,22,1722,0,0,0,1768
2016-04-10,8,0,27,47,2021,2,0,0,2105
2016-04-11,11,1,68,56,4822,5,0,2,4965
2016-04-12,8,0,71,67,4617,6,0,0,4769
2016-04-13,11,0,59,64,4411,6,0,0,4551
2016-04-14,8,0,52,41,4053,5,0,0,4159
2016-04-15,5,0,41,51,2878,1,0,0,2976
2016-04-16,7,0,33,39,1621,0,0,0,1700
2016-04-17,6,0,23,35,1703,0,0,0,1767
2016-04-18,10,0,72,66,4379,10,0,0,4537
2016-04-19,8,0,59,55,4468,3,0,0,4593
2016-04-20,9,0,43,54,3940,5,0,0,4051
2016-04-21,5,0,50,47,3997,10,0,0,4109
2016-04-22,9,0,47,41,2791,0,0,0,2888
2016-04-23,3,0,35,36,1780,0,0,0,1854
2016-04-24,8,0,31,40,1812,0,0,0,1891
2016-04-25,12,0,53,51,4416,11,0,0,4543
2016-04-26,11,0,65,54,4327,3,0,0,4460
2016-04-27,15,0,47,58,4235,8,0,0,4363
2016-04-28,8,0,40,51,3850,5,0,0,3954
2016-04-29,5,0,42,50,2608,0,0,0,2705
2016-04-30,2,0,22,34,1320,0,0,0,1378
2016-05-01,4,0,23,28,1690,0,0,0,1745
2016-05-02,7,0,50,53,4398,8,0,0,4516
2016-05-03,8,0,62,56,4706,4,0,0,4836
2016-05-04,6,0,65,62,4362,6,0,0,4501
2016-05-05,8,0,42,63,3818,3,0,0,3934
2016-05-06,4,0,42,38,2172,1,0,0,2257
2016-05-07,6,0,20,22,1199,0,0,0,1247
2016-05-08,3,0,27,32,1504,0,0,0,1566
2016-05-09,8,0,59,51,4237,6,0,2,4363
2016-05-10,7,0,57,58,4262,4,0,0,4388
2016-05-11,11,0,65,54,4124,7,0,0,4261
2016-05-12,7,0,46,43,3859,4,0,0,3959
2016-05-13,4,0,36,48,2426,6,0,0,2520
2016-05-14,6,0,31,27,1766,2,0,0,1832
2016-05-15,8,0,26,35,1701,1,0,0,1771
2016-05-16,7,0,52,58,4117,6,0,1,4241
2016-05-17,8,0,53,57,4150,5,0,0,4273
2016-05-18,8,0,52,52,3905,7,0,0,4024
2016-05-19,4,0,48,47,3376,3,0,0,3478
2016-05-20,10,0,36,45,2184,2,0,0,2277
2016-05-21,3,0,34,26,1435,2,0,0,1500
2016-05-22,6,0,30,30,1449,1,0,0,1516
2016-05-23,14,0,53,45,3804,9,0,1,3926
2016-05-24,7,0,49,43,3819,3,0,0,3921
2016-05-25,8,0,54,36,3620,7,0,0,3725
2016-05-26,7,0,51,45,3253,3,0,0,3359
2016-05-27,8,0,30,34,2017,2,0,0,2091
2016-05-28,3,0,24,24,1232,0,0,0,1283
2016-05-29,5,0,21,29,1358,2,0,0,1415
2016-05-30,5,0,24,32,1316,0,0,0,1377
2016-05-31,3,0,44,52,3590,4,0,0,3693
2016-06-01,12,0,53,41,3635,5,0,0,3746
2016-06-02,8,0,45,47,3363,3,0,0,3466
2016-06-03,8,0,43,40,2129,5,0,0,2225
2016-06-04,5,0,31,31,1377,0,0,0,1444
2016-06-05,6,0,25,30,1527,0,0,0,1588
2016-06-06,8,0,35,45,2249,5,0,0,2342
2016-06-07,8,0,45,52,1898,0,0,0,2003
2016-06-08,1,0,32,46,1614,0,0,0,1693
2016-06-09,6,0,26,29,1126,1,0,0,1188
2016-06-10,8,0,22,33,784,3,0,0,850
2016-06-11,6,0,10,10,0,0,0,0,26
2016-06-12,3,0,13,9,0,0,0,0,25
2016-06-13,7,0,24,24,401,4,0,0,460
2016-06-14,7,0,25,27,543,2,0,0,604
2016-06-15,6,0,21,35,540,1,0,0,603
2016-06-16,8,0,18,28,510,0,0,0,564
2016-06-17,0,0,21,27,484,0,0,0,532
2016-06-18,0,0,0,0,0,0,0,0,0
2016-06-19,0,0,0,0,0,0,0,0,0
2016-06-20,10,0,29,23,1252,41,0,0,1355
2016-06-21,18,0,30,27,942,30,0,0,1047
2016-06-22,13,0,26,27,860,30,0,0,956
2016-06-23,19,0,27,17,746,18,0,0,827
2016-06-24,16,0,26,21,670,35,0,0,768
2016-06-25,6,0,17,13,332,4,0,0,372
2016-06-26,4,0,10,19,317,14,0,0,364
2016-06-27,17,0,38,36,928,21,0,0,1040
2016-06-28,18,0,35,40,953,11,0,0,1057
2016-06-29,17,0,37,35,803,10,0,0,902
2016-06-30,12,0,27,22,759,8,0,0,828
2016-07-01,17,0,33,37,667,8,0,0,762
2016-07-02,5,0,11,8,328,5,0,0,357
2016-07-03,6,0,17,16,316,6,0,0,361
2016-07-04,3,0,22,19,254,8,0,0,306
2016-07-05,14,0,38,25,713,11,0,0,801
2016-07-06,10,0,28,33,812,8,0,0,891
2016-07-07,11,0,34,25,791,12,0,0,873
2016-07-08,12,0,25,26,634,16,0,0,713
2016-07-09,5,0,19,18,414,4,0,0,460
2016-07-10,4,0,14,13,346,7,0,0,384
2016-07-11,21,0,29,35,849,8,0,0,942
2016-07-12,11,0,26,26,820,8,0,0,891
2016-07-13,7,0,23,28,761,2,0,0,821
2016-07-14,8,0,33,21,627,0,0,0,689
2016-07-15,19,0,34,27,534,13,0,0,627
2016-07-16,5,0,19,15,310,4,0,0,353
2016-07-17,8,0,16,14,340,2,0,0,380
2016-07-18,18,0,25,29,797,10,0,0,879
2016-07-19,14,0,36,27,800,9,0,0,886
2016-07-20,14,0,32,30,727,5,0,0,808
2016-07-21,13,0,27,23,699,7,0,0,769
2016-07-22,11,0,27,27,574,2,0,0,641
2016-07-23,8,0,14,15,275,3,0,0,315
2016-07-24,8,0,21,19,286,3,0,0,337
2016-07-25,10,0,39,35,746,5,0,0,835
2016-07-26,6,0,29,28,741,2,0,0,806
2016-07-27,8,0,34,30,739,6,0,0,817
2016-07-28,3,0,34,25,669,3,0,0,734
2016-07-29,9,0,23,29,530,3,0,0,594
2016-07-30,1,0,20,20,255,0,0,0,296
2016-07-31,3,0,18,19,312,1,0,0,353
2016-08-01,9,0,36,32,727,2,0,0,806
2016-08-02,6,0,37,37,676,3,0,0,759
2016-08-03,9,0,35,32,717,5,0,0,798
2016-08-04,4,0,38,30,680,5,0,0,757
2016-08-05,12,0,32,36,607,1,0,0,688
2016-08-06,1,0,17,12,275,1,0,0,306
2016-08-07,7,0,21,19,306,1,0,0,354
2016-08-08,4,0,36,33,634,0,0,0,707
2016-08-09,10,0,32,25,632,1,0,0,700
2016-08-10,13,0,43,40,560,4,0,0,660
2016-08-11,5,0,32,29,481,2,0,0,549
2016-08-12,11,0,22,30,400,2,0,0,465
2016-08-13,3,0,21,19,211,2,0,0,256
2016-08-14,4,0,18,16,223,0,0,0,261
2016-08-15,5,0,33,27,499,1,0,0,565
2016-08-16,14,0,37,27,486,1,0,0,565
2016-08-17,9,0,31,32,497,2,0,0,571
2016-08-18,10,0,24,20,403,1,0,0,458
2016-08-19,12,0,26,33,343,1,0,0,415
2016-08-20,0,0,0,0,0,0,0,0,0
2016-08-21,0,0,0,0,0,0,0,0,0
2016-08-22,0,0,0,0,0,0,0,0,0
2016-08-23,0,0,0,0,0,10,0,0,10
2016-08-24,0,0,0,0,0,0,0,0,0
2016-08-25,0,0,0,0,0,0,0,0,0
2016-08-26,0,0,0,0,1,8,0,0,9
2016-08-27,0,0,0,0,0,0,0,0,0
2016-08-28,0,0,0,0,0,0,0,0,0
2016-08-29,7,0,31,24,444,0,0,0,506
2016-08-30,5,0,25,19,386,0,0,0,435
2016-08-31,7,0,30,25,354,1,0,0,417
2016-09-01,3,0,26,12,330,2,0,0,373
2016-09-02,9,0,23,25,267,0,0,0,324
2016-09-03,0,0,0,0,0,0,0,0,0
2016-09-04,0,0,0,0,0,0,0,0,0
2016-09-05,0,0,0,0,0,0,0,0,0
2016-09-06,13,0,34,34,352,2,0,0,435
2016-09-07,5,0,39,30,402,1,0,0,477
2016-09-08,7,0,32,22,300,3,0,0,364
2016-09-09,8,0,25,27,262,3,0,0,325
2016-09-10,0,0,0,0,0,0,0,0,0
2016-09-11,0,0,1,0,0,0,0,0,1
2016-09-12,17,0,37,35,319,2,0,0,410
2016-09-13,13,0,30,28,342,6,0,0,419
2016-09-14,13,0,40,25,297,3,0,0,378
2016-09-15,8,0,30,22,294,1,0,0,355
2016-09-16,10,0,36,23,257,2,0,0,328
2016-09-17,0,0,0,0,1,0,0,0,1
2016-09-18,0,0,0,0,1,0,0,0,1
2016-09-19,2,0,41,25,998,27,0,0,1093
2016-09-20,7,0,39,26,1150,9,0,0,1231
2016-09-21,4,0,42,22,1253,10,0,0,1331
2016-09-22,2,0,41,25,2356,9,0,1,2434
2016-09-23,9,0,34,19,2353,20,0,0,2435
2016-09-24,2,0,9,4,1159,3,0,0,1177
2016-09-25,1,0,24,16,2376,1,0,0,2418
2016-09-26,6,0,46,47,5999,33,0,0,6131
2016-09-27,10,0,52,40,5526,32,0,0,5660
2016-09-28,7,0,45,44,4829,23,0,0,4948
2016-09-29,8,0,51,39,4275,18,0,0,4391
2016-09-30,12,0,53,38,3204,8,0,0,3315
2016-10-01,4,0,28,23,1785,1,0,0,1841
2016-10-02,3,0,31,26,1951,2,0,0,2013
2016-10-03,12,0,65,53,4559,21,0,0,4710
2016-10-04,10,0,65,52,4415,25,0,0,4567
2016-10-05,16,0,68,67,4528,19,0,0,4698
2016-10-06,8,0,61,43,3981,18,0,0,4111
2016-10-07,9,0,38,39,2671,9,0,0,2766
2016-10-08,3,0,20,25,1061,1,0,0,1110
2016-10-09,0,0,23,34,1734,0,0,0,1791
2016-10-10,11,0,47,61,4391,15,0,0,4525
2016-10-11,6,0,61,54,4406,26,0,0,4553
2016-10-12,8,0,59,60,4102,20,0,0,4249
2016-10-13,6,0,47,39,3629,25,0,2,3748
2016-10-14,8,0,42,44,2620,6,0,0,2720
2016-10-15,11,0,26,30,1787,0,0,0,1854
2016-10-16,9,0,33,31,1706,2,0,0,1781
2016-10-17,5,0,60,53,4023,18,0,0,4159
2016-10-18,10,0,54,49,4132,21,0,0,4266
2016-10-19,18,0,58,58,3936,17,0,0,4087
2016-10-20,11,0,44,36,3455,25,0,0,3571
2016-10-21,20,0,35,37,2530,4,0,0,2626
2016-10-22,4,0,23,24,1464,1,0,0,1516
2016-10-23,8,0,21,36,1587,1,0,0,1653
2016-10-24,14,0,59,52,3973,18,0,0,4116
2016-10-25,12,0,57,47,3933,28,0,2,4079
2016-10-26,21,0,55,48,3811,24,0,0,3959
2016-10-27,13,0,49,35,3426,26,0,1,3550
2016-10-28,13,0,37,44,2068,6,0,0,2168
2016-10-29,3,0,22,21,856,0,0,0,902
2016-10-30,6,0,32,30,1480,0,0,0,1548
2016-10-31,9,0,48,58,3636,22,0,1,3774
2016-11-01,13,0,52,54,3965,23,0,3,4110
2016-11-02,13,0,62,59,3897,21,0,1,4053
2016-11-03,12,0,60,47,3811,28,0,0,3958
2016-11-04,12,0,47,39,2645,4,0,0,2747
2016-11-05,2,0,36,29,2151,2,0,0,2220
2016-11-06,3,0,27,28,2192,2,0,0,2252
2016-11-07,15,0,58,59,3942,24,0,0,4098
2016-11-08,13,0,53,47,3963,26,0,2,4104
2016-11-09,14,0,42,55,3579,22,0,1,3713
2016-11-10,8,0,52,53,3506,21,0,1,3641
2016-11-11,13,0,53,39,2424,6,0,0,2535
2016-11-12,1,0,27,24,1086,0,0,0,1138
2016-11-13,5,0,33,32,1764,3,0,0,1837
2016-11-14,17,0,64,59,4036,24,0,0,4200
2016-11-15,18,0,62,58,3994,25,0,3,4160
2016-11-16,14,0,66,66,3827,27,0,0,4000
2016-11-17,7,0,55,50,3477,23,0,0,3612
2016-11-18,16,0,46,55,2412,8,0,0,2537
2016-11-19,8,0,27,31,1667,0,0,0,1733
2016-11-20,5,0,31,37,1551,5,0,0,1629
2016-11-21,20,0,71,59,3481,22,0,0,3653
2016-11-22,14,0,57,50,2927,22,0,2,3072
2016-11-23,10,0,39,47,1531,24,0,0,1651
2016-11-24,0,0,0,0,0,0,0,0,0
2016-11-25,0,0,0,0,0,0,0,0,0
2016-11-26,0,0,0,0,0,0,0,0,0
2016-11-27,11,0,29,36,1097,3,0,0,1176
2016-11-28,16,0,62,41,3610,23,0,1,3753
2016-11-29,14,0,60,50,3766,20,0,1,3911
2016-11-30,17,0,53,50,3503,24,0,0,3647
2016-12-01,12,0,48,45,3344,24,0,1,3474
2016-12-02,17,0,55,48,2379,10,0,0,2509
2016-12-03,2,0,35,33,1664,1,0,0,1735
2016-12-04,9,0,43,27,1534,4,0,0,1617
2016-12-05,14,0,56,62,2309,5,0,0,2446
2016-12-06,19,0,60,45,2144,7,0,0,2275
2016-12-07,11,0,47,58,1780,7,0,0,1903
2016-12-08,9,0,58,37,1160,5,0,0,1269
2016-12-09,13,0,50,47,961,5,0,0,1076
2016-12-10,0,0,0,0,0,0,0,0,0
2016-12-11,0,0,0,0,0,0,0,0,0
2016-12-12,17,0,59,56,918,2,0,0,1052
2016-12-13,10,0,49,37,612,7,0,0,715
2016-12-14,12,0,48,42,438,1,0,0,541
2016-12-15,0,0,0,0,0,0,0,0,0
2016-12-16,0,0,0,0,0,0,0,0,0
2016-12-17,0,0,0,0,0,0,0,0,0
2016-12-18,0,0,0,0,0,0,0,0,0
2016-12-19,5,0,56,45,429,0,0,0,535
2016-12-20,8,0,42,39,383,3,0,0,475
2016-12-21,9,0,35,39,295,1,0,0,379
2016-12-22,4,0,42,34,261,3,0,0,344
2016-12-23,5,0,39,32,199,4,0,0,279
2016-12-24,0,0,0,0,0,0,0,0,0
2016-12-25,0,0,0,0,0,0,0,0,0
2016-12-26,0,0,0,0,0,0,0,0,0
2016-12-27,12,0,49,40,323,4,0,0,428
2016-12-28,9,0,32,41,311,3,0,0,396
2016-12-29,9,0,42,40,312,1,0,0,404
2016-12-30,7,0,37,31,315,4,0,0,394
2016-12-31,0,0,0,0,0,0,0,0,0
2017-01-01,0,0,0,0,0,0,0,0,0
2017-01-02,0,0,0,0,0,0,0,0,0
2017-01-03,9,0,49,42,587,4,0,0,691
2017-01-04,2,0,21,14,221,2,0,0,260
2017-01-05,6,0,39,25,531,7,0,0,608
2017-01-06,6,0,41,34,678,7,0,0,766
2017-01-07,0,0,0,0,0,0,0,0,0
2017-01-08,1,0,20,16,908,1,0,0,946
2017-01-09,16,0,44,47,3148,8,0,0,3263
2017-01-10,21,0,69,47,5247,25,0,0,5409
2017-01-11,22,0,58,61,5147,30,0,0,5318
2017-01-12,16,0,60,39,4547,22,0,0,4684
2017-01-13,15,0,52,63,3075,7,0,0,3212
2017-01-14,13,0,32,28,1893,1,0,0,1967
2017-01-15,8,0,35,44,2167,7,0,0,2261
2017-01-16,9,0,36,40,2612,4,0,0,2701
2017-01-17,15,0,67,61,5247,16,0,1,5407
2017-01-18,29,0,67,71,5268,31,0,0,5466
2017-01-19,13,0,67,54,4519,17,0,1,4671
2017-01-20,19,0,51,62,3329,11,0,0,3472
2017-01-21,4,0,33,28,1954,1,0,0,2020
2017-01-22,15,0,29,44,2217,3,0,0,2308
2017-01-23,17,0,74,67,5320,31,0,0,5509
2017-01-24,20,0,80,69,5040,22,0,1,5232
2017-01-25,20,0,79,57,4695,24,0,1,4876
2017-01-26,19,0,79,56,4570,25,0,1,4750
2017-01-27,17,0,58,58,2912,13,0,1,3059
2017-01-28,6,0,36,28,1996,4,0,0,2070
2017-01-29,7,0,33,33,2271,4,0,0,2348
2017-01-30,15,0,76,51,4642,32,0,0,4816
2017-01-31,18,0,75,63,4707,19,0,1,4883
2017-02-01,15,0,66,48,4556,32,0,0,4717
2017-02-02,19,0,66,45,4092,23,0,2,4247
2017-02-03,13,0,50,57,2803,10,0,1,2934
2017-02-04,10,0,43,36,1947,8,0,0,2044
2017-02-05,10,0,34,38,1607,7,0,0,1696
2017-02-06,13,0,71,57,4626,30,0,1,4798
2017-02-07,12,0,71,67,4820,24,0,1,4995
2017-02-08,15,0,65,54,4691,33,0,0,4858
2017-02-09,15,0,68,47,4344,19,0,2,4495
2017-02-10,12,0,58,52,2909,15,0,2,3048
2017-02-11,10,0,43,30,1893,9,0,0,1985
2017-02-12,9,0,40,37,2116,6,0,0,2208
2017-02-13,11,0,96,59,4435,21,0,0,4622
2017-02-14,16,0,69,49,4141,21,0,0,4296
2017-02-15,11,0,69,48,4537,20,0,1,4686
2017-02-16,20,0,76,51,4093,35,0,1,4276
2017-02-17,19,0,62,58,2932,14,0,1,3086
2017-02-18,11,0,34,34,1597,0,0,0,1676
2017-02-19,12,0,36,55,2024,4,0,0,2131
2017-02-20,14,0,80,69,4607,26,0,2,4798
2017-02-21,14,0,71,54,4483,17,0,0,4639
2017-02-22,10,0,68,72,4292,21,0,2,4465
2017-02-23,12,0,59,42,4116,15,0,1,4245
2017-02-24,11,0,49,41,2801,12,0,2,2916
2017-02-25,3,0,20,36,1681,4,0,0,1744
2017-02-26,11,0,43,45,2210,5,0,0,2314
2017-02-27,13,0,72,55,4236,24,0,1,4401
2017-02-28,16,0,72,53,4547,18,0,0,4706
2017-03-01,19,0,72,53,4521,27,0,1,4693
2017-03-02,13,0,59,41,3854,14,0,2,3983
2017-03-03,17,0,49,40,2741,4,0,2,2853
2017-03-04,6,0,36,30,1782,4,0,0,1858
2017-03-05,12,0,39,35,1895,7,0,0,1988
2017-03-06,14,0,77,63,4192,21,0,1,4368
2017-03-07,15,0,73,58,4399,14,0,1,4560
2017-03-08,11,0,71,54,4150,31,0,1,4318
2017-03-09,21,0,58,61,4138,19,0,1,4298
2017-03-10,13,0,45,48,2681,10,0,2,2799
2017-03-11,8,0,27,37,1885,3,0,0,1960
2017-03-12,3,0,33,29,1719,2,0,0,1786
2017-03-13,17,0,65,58,4347,23,0,0,4510
2017-03-14,15,0,71,52,4098,18,0,1,4255
2017-03-15,12,0,68,52,4069,24,0,1,4226
2017-03-16,10,0,51,53,3853,23,0,2,3992
2017-03-17,13,0,52,46,2607,14,0,1,2733
2017-03-18,9,0,51,32,1876,4,0,0,1972
2017-03-19,4,0,34,35,1678,8,0,0,1759
2017-03-20,13,0,69,51,2481,11,0,0,2625
2017-03-21,12,0,56,50,2249,8,0,0,2375
2017-03-22,15,0,67,50,1867,5,0,0,2004
2017-03-23,10,0,28,41,1092,5,0,0,1176
2017-03-24,13,0,31,32,743,4,0,0,823
2017-03-25,0,0,0,0,0,0,0,0,0
2017-03-26,0,0,0,0,0,0,0,0,0
2017-03-27,9,0,28,43,625,6,0,0,711
2017-03-28,15,0,31,37,611,1,0,0,695
2017-03-29,11,0,28,36,510,3,0,0,588
2017-03-30,6,0,31,37,495,4,0,0,573
2017-03-31,11,0,22,36,517,1,0,0,587
2017-04-01,0,0,0,0,0,0,0,0,0
2017-04-02,2,0,14,13,820,9,0,0,858
2017-04-03,14,0,45,50,5136,30,0,1,5276
2017-04-04,22,0,49,54,5075,31,0,0,5231
2017-04-05,16,0,53,54,5056,28,0,1,5208
2017-04-06,11,0,48,46,4682,25,0,1,4813
2017-04-07,10,0,49,52,2981,12,0,0,3104
2017-04-08,4,0,35,27,2041,4,0,0,2111
2017-04-09,7,0,34,29,1894,7,0,0,1971
2017-04-10,25,0,67,64,5255,35,0,0,5446
2017-04-11,12,0,49,36,4712,21,0,0,4830
2017-04-12,11,0,57,52,4790,28,0,0,4938
2017-04-13,16,0,64,58,4196,30,0,0,4364
2017-04-14,14,0,53,56,2785,14,0,1,2923
2017-04-15,4,0,39,22,1381,4,0,0,1450
2017-04-16,7,0,27,17,1292,2,0,0,1345
2017-04-17,12,0,61,48,4619,39,0,1,4780
2017-04-18,16,0,65,46,4720,30,0,0,4877
2017-04-19,12,0,58,59,4614,51,0,1,4795
2017-04-20,9,0,47,47,3706,34,0,0,3843
2017-04-21,9,0,47,35,2444,8,0,1,2544
2017-04-22,12,0,40,29,1692,6,0,0,1779
2017-04-23,9,0,35,22,1757,6,0,0,1829
2017-04-24,16,0,65,56,4409,28,0,1,4575
2017-04-25,17,0,63,53,4300,30,0,0,4463
2017-04-26,18,0,56,43,4263,37,0,1,4418
2017-04-27,14,0,54,38,3835,31,0,0,3972
2017-04-28,18,0,48,36,2482,11,0,0,2595
2017-04-29,3,0,28,28,1178,3,0,0,1240
2017-04-30,13,0,23,19,1876,8,0,0,1939
2017-05-01,7,0,70,51,4405,29,0,1,4563
2017-05-02,17,0,52,47,4111,29,0,0,4256
2017-05-03,6,0,52,53,4417,33,0,0,4561
2017-05-04,16,0,45,41,3716,32,0,0,3850
2017-05-05,11,0,59,43,2451,13,0,0,2577
2017-05-06,3,0,31,19,1471,7,0,0,1531
2017-05-07,3,0,31,24,1543,6,0,0,1607
2017-05-08,6,0,60,47,4312,31,0,0,4456
2017-05-09,14,0,60,50,4137,31,0,0,4292
2017-05-10,11,0,60,39,3927,26,0,0,4063
2017-05-11,15,0,52,35,3481,26,0,0,3609
2017-05-12,21,0,51,36,2366,13,0,0,2487
2017-05-13,6,0,32,26,1494,1,0,0,1559
2017-05-14,4,0,22,20,1457,8,0,0,1511
2017-05-15,18,0,59,49,4281,31,0,1,4439
2017-05-16,13,0,61,43,3920,32,0,0,4069
2017-05-17,9,0,64,59,3943,23,0,0,4098
2017-05-18,14,0,62,40,3437,22,0,0,3575
2017-05-19,10,0,41,37,2065,9,0,0,2162
2017-05-20,3,0,27,17,1194,3,0,0,1244
2017-05-21,5,0,29,25,1368,6,0,0,1433
2017-05-22,9,0,58,57,4066,27,0,0,4217
2017-05-23,16,0,54,42,3729,25,0,0,3866
2017-05-24,9,0,54,35,3809,25,0,1,3933
2017-05-25,7,0,48,36,3139,22,0,0,3252
2017-05-26,10,0,37,27,1818,9,0,1,1902
2017-05-27,6,0,17,21,964,1,0,0,1009
2017-05-28,0,0,25,19,967,3,0,0,1014
2017-05-29,2,0,24,21,1131,2,0,0,1180
2017-05-30,12,0,45,40,3478,25,0,0,3600
2017-05-31,12,0,52,38,3809,24,0,0,3935
2017-06-01,6,0,47,32,3179,24,0,0,3288
2017-06-02,18,0,38,37,2126,9,0,1,2229
2017-06-03,4,0,30,10,1334,3,0,0,1381
2017-06-04,5,0,17,28,1340,3,0,0,1393
2017-06-05,11,0,49,39,3631,30,0,1,3761
2017-06-06,7,0,50,34,3293,23,0,0,3407
2017-06-07,10,0,37,41,3330,20,0,2,3440
2017-06-08,11,0,43,37,3147,25,0,0,3263
2017-06-09,9,0,33,27,1961,11,0,0,2041
2017-06-10,3,0,31,29,1329,4,0,0,1396
2017-06-11,5,0,23,27,1107,3,0,0,1165
2017-06-12,7,0,35,27,1685,4,0,1,1759
2017-06-13,14,0,41,38,1635,3,0,0,1731
2017-06-14,10,0,28,35,1355,6,0,0,1434
2017-06-15,8,0,21,22,814,4,0,0,869
2017-06-16,3,0,22,22,693,6,0,0,746
2017-06-17,5,0,11,17,339,7,0,0,379
2017-06-18,2,0,13,16,296,10,0,0,337
2017-06-19,3,0,20,21,371,9,0,0,424
2017-06-20,6,0,25,21,445,10,0,0,507
2017-06-21,4,0,24,24,482,8,0,0,542
2017-06-22,9,0,22,16,454,9,0,0,510
2017-06-23,5,0,24,20,420,12,0,0,481
2017-06-24,0,0,0,0,0,0,0,0,0
2017-06-25,0,0,0,0,0,0,0,0,0
2017-06-26,13,0,27,19,720,15,0,0,794
2017-06-27,12,0,24,21,847,34,0,0,938
2017-06-28,16,0,28,25,795,29,0,0,893
2017-06-29,9,0,28,23,704,13,0,0,777
2017-06-30,8,0,29,24,536,24,0,0,621
2017-07-01,5,0,15,6,259,7,0,0,292
2017-07-02,5,0,10,11,283,8,0,0,317
2017-07-03,7,0,31,25,715,16,0,0,794
2017-07-04,0,0,0,0,0,0,0,0,0
2017-07-05,7,0,33,24,669,21,0,0,754
2017-07-06,12,0,25,28,706,18,0,0,789
2017-07-07,9,0,33,20,590,19,0,0,671
2017-07-08,4,0,14,12,270,8,0,0,308
2017-07-09,10,0,23,11,264,7,0,0,315
2017-07-10,10,0,35,29,809,17,0,0,900
2017-07-11,13,0,27,21,761,21,0,0,843
2017-07-12,8,0,28,26,718,19,0,0,799
2017-07-13,18,0,28,20,637,27,0,0,730
2017-07-14,9,0,28,21,548,24,0,0,630
2017-07-15,2,0,19,10,293,9,0,0,333
2017-07-16,2,0,15,12,275,11,0,0,315
2017-07-17,9,0,34,36,741,30,0,0,850
2017-07-18,10,0,23,30,669,34,0,0,766
2017-07-19,14,0,32,23,664,22,0,0,755
2017-07-20,12,0,22,17,543,19,0,0,613
2017-07-21,4,0,24,24,472,19,0,0,543
2017-07-22,3,0,16,7,205,3,0,0,234
2017-07-23,3,0,23,13,258,4,0,0,301
2017-07-24,12,0,31,23,681,21,0,0,768
2017-07-25,13,0,32,19,704,17,0,0,785
2017-07-26,16,0,33,26,679,22,0,0,776
2017-07-27,12,0,27,17,625,25,0,0,706
2017-07-28,12,0,35,17,475,15,0,0,554
2017-07-29,1,0,18,9,206,3,0,0,237
2017-07-30,4,0,20,14,208,4,0,0,250
2017-07-31,16,0,32,28,644,11,0,0,731
2017-08-01,7,0,35,26,614,17,0,0,699
2017-08-02,10,0,35,20,580,10,0,0,655
2017-08-03,10,0,25,13,489,16,0,0,553
2017-08-04,7,0,29,23,482,12,0,0,553
2017-08-05,4,0,17,10,221,5,0,0,257
2017-08-06,4,0,24,22,274,5,0,0,329
2017-08-07,10,0,40,27,656,16,0,0,749
2017-08-08,8,0,37,20,623,16,0,0,704
2017-08-09,15,0,32,30,597,17,0,0,691
2017-08-10,13,0,29,18,523,19,0,0,602
2017-08-11,14,0,23,25,432,20,0,0,514
2017-08-12,2,0,17,13,195,2,0,0,229
2017-08-13,6,0,18,16,225,8,0,0,273
2017-08-14,15,0,31,25,551,16,0,0,638
2017-08-15,10,0,28,17,486,22,0,0,563
2017-08-16,13,0,30,20,429,20,0,0,512
2017-08-17,11,0,34,17,397,18,0,0,477
2017-08-18,10,0,23,24,402,14,0,0,473
2017-08-19,0,0,0,0,0,0,0,0,0
2017-08-20,0,0,0,0,0,0,0,0,0
2017-08-21,6,0,29,12,372,9,0,0,428
2017-08-22,16,0,35,20,438,19,0,0,528
2017-08-23,9,0,25,27,417,11,0,0,489
2017-08-24,16,0,27,20,403,12,0,0,478
2017-08-25,14,0,24,23,378,14,0,0,453
2017-08-26,0,0,0,0,0,0,0,0,0
2017-08-27,0,0,0,0,0,0,0,0,0
2017-08-28,0,0,0,0,0,0,0,0,0
2017-08-29,0,0,0,0,1,1,0,0,2
2017-08-30,0,0,0,0,0,2,0,0,2
2017-08-31,0,0,0,0,0,0,0,0,0
2017-09-01,0,0,0,0,0,0,0,0,0
2017-09-02,0,0,0,0,0,0,0,0,0
2017-09-03,0,0,0,0,0,0,0,0,0
2017-09-04,0,0,0,0,0,0,0,0,0
2017-09-05,0,0,0,0,0,0,0,0,0
2017-09-06,14,0,42,27,628,25,0,0,736
2017-09-07,12,0,38,21,500,14,0,0,585
2017-09-08,14,0,33,30,399,17,0,0,493
2017-09-09,0,0,0,0,0,0,0,0,0
2017-09-10,0,0,0,0,0,0,0,0,0
2017-09-11,9,0,40,34,546,22,0,0,651
2017-09-12,13,0,35,22,474,17,0,0,561
2017-09-13,9,0,39,36,477,21,0,0,582
2017-09-14,8,0,34,24,406,19,0,0,491
2017-09-15,10,0,25,28,355,10,0,0,428
2017-09-16,0,0,0,0,0,0,0,0,0
2017-09-17,0,0,0,0,0,6,0,0,6
2017-09-18,3,0,34,36,1081,41,0,0,1195
2017-09-19,5,0,27,28,1222,21,0,0,1303
2017-09-20,7,0,32,32,1366,17,0,0,1454
2017-09-21,4,0,31,25,2375,14,0,0,2449
2017-09-22,16,0,32,22,2252,19,0,0,2341
2017-09-23,2,0,21,13,2358,7,0,0,2401
2017-09-24,2,0,23,12,2087,13,0,0,2137
2017-09-25,10,0,53,41,6154,17,0,0,6275
2017-09-26,13,0,61,45,5333,15,0,0,5467
2017-09-27,12,0,48,36,4991,15,0,0,5102
2017-09-28,17,0,55,37,4348,8,0,0,4465
2017-09-29,15,0,35,35,3064,6,0,0,3155
2017-09-30,9,0,25,17,1378,3,0,0,1432
2017-10-01,4,0,26,27,1913,1,0,0,1971
2017-10-02,10,0,45,50,4952,6,0,0,5063
2017-10-03,13,0,59,37,4416,11,0,1,4537
2017-10-04,11,0,52,45,4289,11,0,0,4408
2017-10-05,7,0,52,31,3727,7,0,0,3824
2017-10-06,13,0,31,38,2526,5,0,0,2613
2017-10-07,3,0,22,22,1034,5,0,0,1086
2017-10-08,3,0,35,19,1534,0,0,0,1591
2017-10-09,9,0,64,50,4130,10,0,0,4263
2017-10-10,15,0,62,36,3733,9,0,0,3855
2017-10-11,14,0,62,37,3995,15,0,0,4123
2017-10-12,7,0,42,27,3452,8,0,0,3536
2017-10-13,15,0,45,41,2292,3,0,1,2397
2017-10-14,5,0,23,18,1413,3,0,0,1462
2017-10-15,2,0,23,31,1610,5,0,0,1671
2017-10-16,13,0,59,53,4071,6,0,0,4202
2017-10-17,17,0,55,35,3770,7,0,0,3884
2017-10-18,8,0,57,39,3851,6,0,0,3961
2017-10-19,7,0,46,39,3368,11,0,0,3471
2017-10-20,16,0,41,46,2361,5,0,0,2469
2017-10-21,4,0,29,29,1467,2,0,0,1531
2017-10-22,10,0,27,24,1594,3,0,0,1658
2017-10-23,10,0,48,44,4192,8,0,0,4302
2017-10-24,7,0,54,28,3768,10,0,0,3867
2017-10-25,14,0,65,46,3675,6,0,0,3806
2017-10-26,5,0,52,24,3316,9,0,0,3406
2017-10-27,12,0,44,35,2067,6,0,1,2165
2017-10-28,1,0,25,22,812,2,0,0,862
2017-10-29,7,0,31,25,1266,2,0,0,1331
2017-10-30,10,0,72,40,3708,9,0,2,3841
2017-10-31,13,0,59,44,3356,6,0,0,3478
2017-11-01,6,0,53,41,3483,7,0,0,3590
2017-11-02,10,0,62,40,3384,4,0,0,3500
2017-11-03,11,0,56,44,2214,2,0,0,2327
2017-11-04,13,0,35,28,1456,2,0,0,1534
2017-11-05,6,0,36,37,1492,1,0,0,1572
2017-11-06,9,0,75,56,4062,6,0,1,4209
2017-11-07,14,0,72,41,3844,7,0,0,3978
2017-11-08,18,0,68,49,3736,11,0,0,3882
2017-11-09,0,0,59,46,3411,7,0,0,3523
2017-11-10,17,0,52,48,2272,5,0,2,2396
2017-11-11,5,0,43,29,1763,2,0,1,1843
2017-11-12,5,0,31,30,1697,3,0,0,1766
2017-11-13,8,0,71,48,3911,11,0,0,4049
2017-11-14,18,0,74,49,3848,8,0,0,3997
2017-11-15,13,0,65,42,3649,10,0,0,3779
2017-11-16,12,0,58,44,3490,4,0,0,3608
2017-11-17,13,0,52,39,2311,0,0,1,2416
2017-11-18,7,0,34,26,1017,2,0,0,1086
2017-11-19,6,0,34,30,1373,1,0,0,1444
2017-11-20,15,0,59,50,3538,8,0,0,3670
2017-11-21,15,0,48,47,2839,7,0,0,2956
2017-11-22,12,0,37,27,1440,12,0,0,1528
2017-11-23,0,0,0,0,0,0,0,0,0
2017-11-24,0,0,0,0,0,0,0,0,0
2017-11-25,0,0,0,0,0,0,0,0,0
2017-11-26,9,0,32,26,1166,0,0,0,1233
2017-11-27,8,0,66,43,3651,7,0,0,3775
2017-11-28,10,0,65,55,3342,7,0,0,3479
2017-11-29,9,0,59,45,3362,10,0,0,3485
2017-11-30,10,0,54,39,3126,10,0,0,3239
2017-12-01,13,0,51,38,2208,8,0,0,2318
2017-12-02,9,0,42,31,1473,4,0,0,1559
2017-12-03,3,0,39,40,1641,3,0,0,1726
2017-12-04,8,0,76,42,2342,5,0,0,2473
2017-12-05,10,0,67,48,2068,8,0,0,2201
2017-12-06,16,0,66,48,1717,4,0,0,1851
2017-12-07,8,0,35,39,1111,6,0,0,1199
2017-12-08,11,0,41,50,827,6,0,0,935
2017-12-09,0,0,0,0,0,0,0,0,0
2017-12-10,0,0,0,0,0,0,0,0,0
2017-12-11,10,0,42,51,673,4,0,0,780
2017-12-12,9,0,42,38,624,5,0,0,718
2017-12-13,10,0,48,39,509,5,0,0,611
2017-12-14,13,0,53,31,467,7,0,0,571
2017-12-15,10,0,45,39,390,7,0,0,491
2017-12-16,0,0,0,0,0,0,0,0,0
2017-12-17,0,0,0,0,0,0,0,0,0
2017-12-18,10,0,53,57,461,6,0,0,587
2017-12-19,9,0,44,47,357,4,0,0,461
2017-12-20,10,0,42,36,331,6,0,0,425
2017-12-21,7,0,40,27,272,4,0,0,350
2017-12-22,16,0,28,33,223,2,0,0,302
2017-12-23,0,0,0,0,0,0,0,0,0
2017-12-24,0,0,0,0,0,0,0,0,0
2017-12-25,0,0,0,0,0,0,0,0,0
2017-12-26,5,0,38,32,195,2,0,0,272
2017-12-27,16,0,32,29,255,2,0,0,334
2017-12-28,11,0,33,28,248,2,0,0,322
2017-12-29,18,0,39,40,254,1,0,0,352
2017-12-30,0,0,0,0,0,0,0,0,0
2017-12-31,0,0,0,0,0,0,0,0,0
2018-01-01,0,0,0,0,0,0,0,0,0
2018-01-02,10,0,45,43,462,7,0,0,567
2018-01-03,15,0,44,45,482,6,0,0,592
2018-01-04,5,0,42,32,492,5,0,0,576
2018-01-05,15,0,43,37,569,7,0,0,671
2018-01-06,0,0,0,0,0,0,0,0,0
2018-01-07,2,0,13,21,899,1,0,0,936
2018-01-08,18,0,49,57,5326,15,0,1,5466
2018-01-09,9,0,41,57,5226,7,0,0,5340
2018-01-10,20,0,57,50,5105,14,0,0,5246
2018-01-11,11,0,51,48,4247,14,0,1,4372
2018-01-12,18,0,52,45,3044,6,0,1,3166
2018-01-13,4,0,29,27,1696,1,0,0,1757
2018-01-14,9,0,31,28,1915,2,0,0,1985
2018-01-15,12,0,50,54,2256,2,0,0,2374
2018-01-16,13,0,69,62,5126,12,0,0,5282
2018-01-17,16,0,69,53,5036,13,0,1,5188
2018-01-18,12,0,62,53,4155,10,0,0,4292
2018-01-19,27,0,59,50,3294,3,0,0,3433
2018-01-20,3,0,36,31,1827,2,0,1,1900
2018-01-21,1,0,44,40,1803,4,0,0,1892
2018-01-22,18,0,67,60,5253,15,0,2,5415
2018-01-23,15,0,66,48,4817,18,0,0,4964
2018-01-24,19,0,75,57,4796,14,0,4,4965
2018-01-25,12,0,64,49,4062,15,0,1,4203
2018-01-26,14,0,65,50,2946,8,0,2,3085
2018-01-27,10,0,37,32,1688,5,0,0,1772
2018-01-28,6,0,33,36,2191,5,0,0,2271
2018-01-29,18,0,66,56,4498,14,0,1,4653
2018-01-30,12,0,63,53,4492,15,0,0,4635
2018-01-31,11,0,65,56,4361,16,0,4,4513
2018-02-01,11,0,59,53,4039,16,0,1,4179
2018-02-02,11,0,54,38,2540,3,0,1,2647
2018-02-03,2,0,31,26,2063,7,0,0,2129
2018-02-04,3,0,34,33,1272,0,0,0,1342
2018-02-05,17,0,67,57,4538,14,0,2,4695
2018-02-06,11,0,66,47,4542,10,0,0,4676
2018-02-07,19,0,66,54,4666,15,0,3,4823
2018-02-08,15,0,51,42,3877,12,0,1,3998
2018-02-09,16,0,55,55,2533,4,0,1,2664
2018-02-10,4,0,27,37,1710,5,0,0,1783
2018-02-11,6,0,41,42,1992,5,0,0,2086
2018-02-12,14,0,74,64,4495,14,0,3,4664
2018-02-13,16,0,64,59,4277,12,0,0,4428
2018-02-14,15,0,49,52,3682,14,0,3,3815
2018-02-15,8,0,55,52,3720,11,0,1,3847
2018-02-16,15,0,52,50,2378,5,0,1,2501
2018-02-17,5,0,38,36,1523,3,0,0,1605
2018-02-18,9,0,45,32,1878,3,0,0,1967
2018-02-19,12,0,63,58,4178,15,0,3,4329
2018-02-20,7,0,59,52,4250,17,0,1,4386
2018-02-21,11,0,71,55,4341,15,0,4,4497
2018-02-22,7,0,57,50,3382,14,0,1,3511
2018-02-23,12,0,65,52,2485,6,0,1,2621
2018-02-24,5,0,29,31,1822,6,0,0,1893
2018-02-25,12,0,43,37,1991,5,0,0,2088
2018-02-26,16,0,79,68,4331,15,0,3,4512
2018-02-27,9,0,66,59,4361,19,0,1,4515
2018-02-28,12,0,72,57,4259,13,0,3,4416
2018-03-01,12,0,74,56,3797,17,0,1,3957
2018-03-02,9,0,52,47,2528,3,0,1,2640
2018-03-03,7,0,41,28,1538,2,0,0,1616
2018-03-04,8,0,31,34,1823,4,0,0,1900
2018-03-05,14,0,64,49,4267,12,0,2,4408
2018-03-06,8,0,62,44,4191,10,0,1,4316
2018-03-07,8,0,61,45,4233,10,0,3,4360
2018-03-08,9,0,50,38,3472,13,0,2,3584
2018-03-09,13,0,57,44,2492,3,0,1,2610
2018-03-10,6,0,43,29,1619,1,0,0,1698
2018-03-11,4,0,42,24,1601,3,0,0,1674
2018-03-12,13,0,48,43,3906,13,0,3,4026
2018-03-13,15,0,48,49,3542,15,0,1,3670
2018-03-14,13,0,59,57,3674,13,0,4,3820
2018-03-15,13,0,47,41,3366,16,0,2,3485
2018-03-16,15,0,57,47,2351,5,0,1,2476
2018-03-17,5,0,31,32,1447,1,0,0,1516
2018-03-18,4,0,35,31,1353,2,0,0,1425
2018-03-19,14,0,54,52,2129,3,0,0,2252
2018-03-20,16,0,54,40,1865,6,0,0,1981
2018-03-21,8,0,42,53,1598,3,0,0,1704
2018-03-22,13,0,36,33,985,5,0,0,1072
2018-03-23,11,0,34,36,652,3,0,0,736
2018-03-24,0,0,0,0,0,0,0,0,0
2018-03-25,0,0,0,0,0,0,0,0,0
2018-03-26,13,0,31,39,588,5,0,0,676
2018-03-27,11,0,21,29,480,6,0,0,547
2018-03-28,10,0,29,52,539,5,0,0,635
2018-03-29,10,0,23,33,453,2,0,0,521
2018-03-30,10,0,25,36,527,12,0,0,610
2018-03-31,0,0,0,0,0,0,0,0,0
2018-04-01,1,0,10,14,575,0,0,0,600
2018-04-02,19,0,43,49,4927,16,0,3,5057
2018-04-03,14,0,32,44,4841,11,0,0,4942
2018-04-04,11,0,46,46,4672,14,0,5,4794
2018-04-05,12,0,46,45,4247,15,0,1,4366
2018-04-06,22,0,39,58,2796,7,0,2,2924
2018-04-07,11,0,26,26,1678,7,0,0,1748
2018-04-08,10,0,31,40,2203,7,0,0,2291
2018-04-09,19,0,57,65,5077,18,0,0,5236
2018-04-10,15,0,43,57,4765,20,0,2,4902
2018-04-11,22,0,56,51,4498,15,0,3,4645
2018-04-12,14,0,36,42,3909,15,0,4,4020
2018-04-13,24,0,43,39,2750,8,0,1,2865
2018-04-14,5,0,29,26,1538,4,0,0,1602
2018-04-15,8,0,20,28,1583,4,0,0,1643
2018-04-16,17,0,48,57,4558,16,0,4,4700
2018-04-17,24,0,47,54,4193,9,0,2,4329
2018-04-18,12,0,50,46,4262,15,0,4,4389
2018-04-19,16,0,52,49,3577,13,0,2,3709
2018-04-20,20,0,28,39,2177,4,0,1,2269
2018-04-21,10,0,23,23,996,2,0,0,1054
2018-04-22,1,0,21,32,1434,0,0,0,1488
2018-04-23,10,0,43,55,4248,16,0,1,4373
2018-04-24,13,0,39,49,3931,9,0,0,4041
2018-04-25,13,0,46,45,3821,16,0,2,3943
2018-04-26,12,0,34,44,3443,10,0,1,3544
2018-04-27,9,0,32,33,2212,6,0,1,2293
2018-04-28,8,0,24,35,1456,3,0,0,1526
2018-04-29,6,0,31,26,1542,1,0,0,1606
2018-04-30,14,0,43,59,4233,17,0,1,4367
2018-05-01,14,0,44,45,3693,10,0,0,3806
2018-05-02,18,0,43,47,3874,12,0,2,3996
2018-05-03,12,0,44,30,3525,14,0,1,3626
2018-05-04,20,0,43,50,2212,8,0,2,2335
2018-05-05,3,0,25,27,1089,1,0,1,1146
2018-05-06,7,0,30,21,1452,4,0,0,1514
2018-05-07,11,0,45,65,4020,17,0,0,4158
2018-05-08,9,0,57,53,3872,7,0,0,3998
2018-05-09,10,0,52,56,3912,11,0,1,4042
2018-05-10,7,0,51,52,3520,11,0,1,3642
2018-05-11,11,0,38,41,2155,4,0,1,2250
2018-05-12,7,0,24,24,1332,3,0,0,1390
2018-05-13,1,0,16,20,1227,2,0,0,1266
2018-05-14,10,0,50,51,3936,15,0,1,4063
2018-05-15,12,0,50,61,3735,13,0,0,3871
2018-05-16,9,0,43,45,3685,17,0,1,3800
2018-05-17,8,0,39,60,3104,8,0,0,3219
2018-05-18,9,0,40,28,1913,5,0,1,1996
2018-05-19,3,0,27,22,1086,1,0,0,1139
2018-05-20,3,0,21,25,1303,2,0,0,1354
2018-05-21,12,0,49,59,3942,12,0,0,4074
2018-05-22,9,0,43,43,3526,12,0,0,3633
2018-05-23,10,0,46,35,3495,14,0,2,3602
2018-05-24,4,0,42,42,3072,6,0,0,3166
2018-05-25,9,0,32,32,1869,3,0,3,1948
2018-05-26,2,0,23,17,1038,2,0,0,1082
2018-05-27,3,0,21,17,970,2,0,0,1013
2018-05-28,9,0,23,28,946,3,0,0,1009
2018-05-29,7,0,42,35,3344,14,0,0,3442
2018-05-30,5,0,51,49,3666,13,0,1,3785
2018-05-31,11,0,44,32,3051,10,0,1,3149
2018-06-01,14,0,29,40,2079,4,0,1,2167
2018-06-02,4,0,30,27,1170,0,0,0,1231
2018-06-03,7,0,21,29,1440,2,0,0,1499
2018-06-04,8,0,47,52,3485,12,0,0,3604
2018-06-05,5,0,49,42,3262,10,0,0,3368
2018-06-06,10,0,40,36,3208,12,0,0,3306
2018-06-07,10,0,45,44,2949,7,0,0,3055
2018-06-08,13,0,28,30,1662,6,0,1,1740
2018-06-09,7,0,22,23,1136,3,0,0,1191
2018-06-10,6,0,17,20,1041,1,0,0,1085
2018-06-11,18,0,46,54,1637,4,0,0,1759
2018-06-12,12,0,35,39,1518,6,0,0,1610
2018-06-13,16,0,29,43,1313,7,0,0,1408
2018-06-14,12,0,28,22,816,3,0,0,881
2018-06-15,5,0,26,22,609,3,0,0,665
2018-06-16,4,0,11,17,347,0,0,0,379
2018-06-17,2,0,16,16,277,1,0,0,312
2018-06-18,8,0,29,26,314,1,0,0,378
2018-06-19,11,0,30,37,484,5,0,0,567
2018-06-20,12,0,36,29,473,6,0,0,556
2018-06-21,11,0,22,17,432,4,0,0,486
2018-06-22,12,0,36,31,414,4,0,0,497
2018-06-23,0,0,0,0,0,0,0,0,0
2018-06-24,0,0,0,0,0,0,0,0,0
2018-06-25,21,0,20,21,746,33,0,0,841
2018-06-26,19,0,29,34,787,21,0,0,890
2018-06-27,13,0,29,23,725,19,0,0,809
2018-06-28,16,0,25,29,682,30,0,0,782
2018-06-29,21,0,30,26,585,23,0,0,685
2018-06-30,9,0,19,7,237,8,0,2,282
2018-07-01,4,0,7,11,262,5,0,0,289
2018-07-02,22,0,34,32,702,24,0,0,814
2018-07-03,17,0,45,29,718,30,0,0,839
2018-07-04,0,0,0,0,0,0,0,0,0
2018-07-05,23,0,30,31,612,30,0,0,726
2018-07-06,13,0,33,32,583,16,0,0,677
2018-07-07,7,0,19,18,271,7,0,2,324
2018-07-08,5,0,13,10,270,14,0,0,312
2018-07-09,22,0,41,30,757,32,0,0,882
2018-07-10,23,0,43,30,755,16,0,0,867
2018-07-11,14,0,45,28,677,23,0,0,787
2018-07-12,15,0,26,20,653,28,0,0,742
2018-07-13,17,0,31,25,509,25,0,0,607
2018-07-14,5,0,20,10,252,5,0,1,293
2018-07-15,5,0,13,14,259,17,0,0,308
2018-07-16,21,0,31,37,681,19,0,0,789
2018-07-17,23,0,37,38,703,16,0,0,817
2018-07-18,14,0,29,34,662,22,0,0,761
2018-07-19,12,0,30,36,528,30,0,0,636
2018-07-20,16,0,42,28,474,21,0,0,581
2018-07-21,5,0,15,12,234,6,0,2,274
2018-07-22,2,0,20,12,227,4,0,0,265
2018-07-23,17,0,41,34,642,21,0,0,755
2018-07-24,10,0,34,26,621,22,0,0,713
2018-07-25,14,0,29,27,620,35,0,0,725
2018-07-26,13,0,30,25,576,14,0,1,659
2018-07-27,13,0,35,32,554,16,0,0,650
2018-07-28,6,0,26,13,270,5,0,1,321
2018-07-29,2,0,13,17,239,6,0,0,277
2018-07-30,14,0,48,48,751,27,0,0,888
2018-07-31,19,0,52,43,764,26,0,0,904
2018-08-01,13,0,50,52,673,24,0,1,813
2018-08-02,18,0,40,42,661,30,0,0,791
2018-08-03,20,0,41,44,559,22,0,0,686
2018-08-04,7,0,26,19,317,9,0,2,380
2018-08-05,3,0,31,16,296,9,0,0,355
2018-08-06,10,0,41,56,717,29,0,0,853
2018-08-07,16,0,60,36,705,24,0,0,841
2018-08-08,16,0,34,61,693,26,0,0,830
2018-08-09,11,0,42,35,635,29,0,2,754
2018-08-10,13,0,39,45,589,18,0,0,704
2018-08-11,4,0,19,13,303,17,0,0,356
2018-08-12,3,0,21,16,268,12,0,0,320
2018-08-13,17,0,42,56,614,27,0,0,756
2018-08-14,11,0,40,41,605,22,0,0,719
2018-08-15,16,0,46,45,541,34,0,1,683
2018-08-16,11,0,42,43,457,23,0,1,577
2018-08-17,10,0,33,36,441,17,0,0,537
2018-08-18,1,0,20,17,229,7,0,1,275
2018-08-19,8,0,22,17,227,7,0,0,281
2018-08-20,9,0,43,47,582,18,0,0,699
2018-08-21,15,0,41,31,508,20,0,0,615
2018-08-22,10,0,46,42,499,23,0,1,621
2018-08-23,10,0,40,36,453,24,0,0,563
2018-08-24,11,0,36,42,471,29,0,0,589
2018-08-25,0,0,0,0,0,0,0,0,0
2018-08-26,0,0,0,0,0,0,0,0,0
2018-08-27,0,0,2,2,3,0,0,0,7
2018-08-28,0,0,0,0,0,0,0,0,0
2018-08-29,1,0,2,1,5,0,0,0,9
2018-08-30,0,0,0,0,0,0,0,0,0
2018-08-31,1,0,2,0,11,24,0,0,38
2018-09-01,0,0,0,0,0,0,0,0,0
2018-09-02,0,0,0,0,0,0,0,0,0
2018-09-03,0,0,0,0,0,0,0,0,0
2018-09-04,0,0,0,0,0,0,0,0,0
2018-09-05,1,0,2,2,8,2,0,0,15
2018-09-06,0,0,0,0,0,0,0,0,0
2018-09-07,0,0,0,0,0,5,0,0,5
2018-09-08,0,0,0,0,0,0,0,0,0
2018-09-09,0,0,0,0,0,0,0,0,0
2018-09-10,17,1,25,33,464,27,1,5,573
2018-09-11,16,4,22,32,414,10,0,9,507
2018-09-12,19,3,27,25,347,13,1,7,442
2018-09-13,11,8,19,30,338,13,0,6,425
2018-09-14,11,8,21,25,335,17,0,5,422
2018-09-15,0,0,0,0,0,0,0,0,0
2018-09-16,0,0,0,0,0,0,0,0,0
2018-09-17,14,10,20,32,1053,38,0,11,1178
2018-09-18,7,13,23,34,1028,25,2,5,1137
2018-09-19,8,15,26,28,1232,22,2,4,1337
2018-09-20,6,14,20,26,2850,14,2,9,2941
2018-09-21,7,21,26,34,2012,10,4,13,2127
2018-09-22,0,7,13,9,1192,9,1,9,1240
2018-09-23,2,5,17,9,1922,6,5,7,1973
2018-09-24,11,113,32,42,5680,26,10,22,5936
2018-09-25,9,92,22,38,4883,19,19,18,5100
2018-09-26,10,113,30,44,4637,9,7,31,4881
2018-09-27,7,68,33,33,4116,10,12,18,4297
2018-09-28,9,71,33,35,2710,5,8,22,2893
2018-09-29,4,19,22,18,1706,0,9,19,1797
2018-09-30,5,17,22,18,1706,3,12,17,1800
2018-10-01,14,122,41,42,4906,12,11,39,5187
2018-10-02,14,111,35,38,4609,18,14,39,4878
2018-10-03,8,91,40,39,4237,8,13,29,4465
2018-10-04,12,81,40,29,3538,12,12,23,3747
2018-10-05,11,88,40,32,2224,4,10,26,2435
2018-10-06,4,33,16,17,1527,2,9,15,1623
2018-10-07,2,21,16,20,1404,0,5,18,1486
2018-10-08,17,121,50,53,3861,11,19,34,4166
2018-10-09,11,101,42,46,3776,14,10,29,4029
2018-10-10,15,116,45,39,3701,3,12,30,3961
2018-10-11,13,103,34,31,3366,8,10,23,3588
2018-10-12,13,85,40,32,2163,6,9,17,2365
2018-10-13,6,27,11,19,725,1,4,11,804
2018-10-14,4,20,20,16,1292,2,7,15,1376
2018-10-15,10,97,51,48,3869,11,14,43,4143
2018-10-16,18,97,44,42,3613,12,11,36,3873
2018-10-17,16,110,46,47,3646,6,11,43,3925
2018-10-18,10,76,42,41,3006,9,9,27,3220
2018-10-19,10,87,41,41,2580,8,8,24,2799
2018-10-20,1,23,23,18,1295,0,4,16,1380
2018-10-21,5,16,18,24,1461,1,4,19,1548
2018-10-22,12,129,51,40,3932,14,8,32,4218
2018-10-23,16,109,42,42,3598,11,12,39,3869
2018-10-24,7,107,49,48,3507,10,10,39,3777
2018-10-25,9,90,32,39,3023,10,5,16,3224
2018-10-26,16,89,49,41,2024,7,10,27,2263
2018-10-27,3,23,22,22,1142,1,7,11,1231
2018-10-28,5,23,30,21,1194,6,3,20,1302
2018-10-29,11,116,50,54,3548,12,12,32,3835
2018-10-30,16,98,58,42,3448,17,11,31,3721
2018-10-31,9,116,46,39,3231,12,14,29,3496
2018-11-01,11,97,51,42,2838,19,5,33,3096
2018-11-02,14,100,35,46,2225,8,7,27,2462
2018-11-03,6,34,27,19,850,0,5,11,952
2018-11-04,3,28,30,21,1486,3,3,21,1595
2018-11-05,9,112,71,46,3765,12,6,39,4060
2018-11-06,14,111,55,47,3451,14,14,30,3736
2018-11-07,13,97,54,52,3535,4,4,36,3795
2018-11-08,9,91,50,32,3171,8,8,26,3395
2018-11-09,10,91,43,38,2097,8,7,23,2317
2018-11-10,7,20,25,15,1293,3,7,22,1392
2018-11-11,0,31,28,24,1412,5,5,12,1517
2018-11-12,8,121,58,46,3794,11,10,33,4081
2018-11-13,19,111,71,52,3319,10,4,38,3624
2018-11-14,8,95,49,45,3453,11,6,24,3691
2018-11-15,11,85,57,40,2957,7,10,21,3188
2018-11-16,14,82,35,44,2199,1,8,30,2413
2018-11-17,5,24,23,36,1089,3,7,21,1208
2018-11-18,5,20,24,28,1315,0,3,17,1412
2018-11-19,13,116,42,48,3304,5,9,31,3568
2018-11-20,14,90,59,41,2482,8,4,25,2723
2018-11-21,19,83,35,43,1442,6,7,19,1654
2018-11-22,0,0,0,0,0,0,0,0,0
2018-11-23,0,0,0,0,0,0,0,0,0
2018-11-24,0,0,0,0,0,0,0,0,0
2018-11-25,8,36,27,29,967,1,2,16,1086
2018-11-26,8,112,37,51,3385,7,10,39,3649
2018-11-27,19,114,50,48,3106,9,6,32,3384
2018-11-28,11,106,46,48,3101,9,9,27,3357
2018-11-29,13,108,41,40,2841,3,5,29,3080
2018-11-30,16,92,36,31,2018,2,8,22,2225
2018-12-01,10,27,21,28,1357,4,5,19,1471
2018-12-02,3,31,25,25,1234,2,3,8,1331
2018-12-03,12,113,49,47,1765,5,8,22,2021
2018-12-04,10,105,51,50,1631,9,7,32,1895
2018-12-05,12,90,44,54,1532,6,8,27,1773
2018-12-06,7,93,33,34,959,9,11,22,1168
2018-12-07,17,81,30,36,777,19,9,29,998
2018-12-08,0,0,0,0,0,0,0,0,0
2018-12-09,0,0,0,0,0,0,0,0,0
2018-12-10,13,98,36,51,627,5,13,19,862
2018-12-11,10,101,50,49,556,5,6,24,801
2018-12-12,9,79,44,31,469,4,11,12,659
2018-12-13,17,79,34,33,421,5,5,13,607
2018-12-14,12,91,30,32,389,8,6,17,585
2018-12-15,0,0,0,0,0,0,0,0,0
2018-12-16,0,0,0,0,0,0,0,0,0
2018-12-17,9,84,48,41,432,4,8,22,648
2018-12-18,15,76,31,34,368,5,6,13,548
2018-12-19,10,90,36,26,327,7,5,19,520
2018-12-20,13,68,33,32,279,4,7,15,451
2018-12-21,15,55,33,39,263,4,9,15,433
2018-12-22,0,0,0,0,0,0,0,0,0
2018-12-23,0,0,0,0,0,0,0,0,0
2018-12-24,0,0,0,0,0,0,0,0,0
2018-12-25,0,0,0,0,0,0,0,0,0
2018-12-26,8,41,31,24,171,1,7,14,297
2018-12-27,8,46,30,23,239,4,5,8,363
2018-12-28,8,57,36,26,238,4,9,14,392
2018-12-29,0,0,0,0,0,0,0,0,0
2018-12-30,0,0,0,0,0,0,0,0,0
2018-12-31,0,0,0,0,0,0,0,0,0
2019-01-01,0,0,0,0,0,0,0,0,0
2019-01-02,9,82,46,34,360,9,7,14,561
2019-01-03,7,62,42,34,475,2,6,8,636
2019-01-04,8,85,39,45,546,13,7,15,758
2019-01-05,0,0,0,0,0,0,0,0,0
2019-01-06,1,5,8,5,529,0,2,1,551
2019-01-07,13,142,36,42,3858,15,18,25,4149
2019-01-08,15,148,31,49,4783,19,18,31,5094
2019-01-09,21,155,52,34,4703,10,19,27,5021
2019-01-10,19,138,45,41,3974,14,16,30,4277
2019-01-11,26,139,38,38,2880,10,15,22,3168
2019-01-12,3,42,26,25,1837,3,1,21,1958
2019-01-13,7,34,24,28,1851,1,6,24,1975
2019-01-14,17,169,42,52,5010,16,26,33,5365
2019-01-15,17,142,43,54,4660,13,21,30,4980
2019-01-16,16,163,35,59,4540,13,16,38,4880
2019-01-17,13,160,33,34,3976,14,18,54,4302
2019-01-18,23,108,33,35,2385,5,23,30,2642
2019-01-19,8,37,23,27,1586,4,8,29,1722
2019-01-20,12,43,21,27,1348,1,8,20,1480
2019-01-21,11,57,32,37,1795,3,15,30,1980
2019-01-22,18,150,49,47,4363,18,25,62,4732
2019-01-23,12,145,48,51,4699,9,29,45,5038
2019-01-24,16,145,44,47,3816,15,21,49,4153
2019-01-25,22,102,31,43,2835,17,17,44,3111
2019-01-26,6,44,16,30,1743,0,10,18,1867
2019-01-27,8,47,27,29,1975,1,13,29,2129
2019-01-28,16,167,49,50,4427,13,29,48,4799
2019-01-29,16,144,55,46,4034,17,25,47,4384
2019-01-30,22,154,36,38,4217,11,26,46,4550
2019-01-31,17,120,43,43,3649,11,15,52,3950
2019-02-01,24,109,27,32,2556,6,18,30,2802
2019-02-02,4,56,28,28,1867,5,14,20,2022
2019-02-03,8,34,26,30,1315,1,5,23,1442
2019-02-04,19,143,34,40,4305,13,19,53,4626
2019-02-05,18,130,42,43,3971,21,20,45,4290
2019-02-06,12,139,38,46,4119,12,18,52,4436
2019-02-07,9,134,30,37,3683,14,23,47,3977
2019-02-08,11,106,40,37,2348,9,21,40,2612
2019-02-09,4,45,28,22,1683,0,11,18,1811
2019-02-10,12,35,24,41,1942,1,17,33,2105
2019-02-11,14,171,49,57,4283,17,28,52,4671
2019-02-12,24,143,45,45,3806,15,23,44,4145
2019-02-13,16,146,47,41,3960,8,23,44,4285
2019-02-14,11,135,33,37,3190,8,20,37,3471
2019-02-15,19,120,34,35,2112,3,17,34,2374
2019-02-16,11,46,28,23,1415,2,10,22,1557
2019-02-17,8,25,16,25,1740,4,12,23,1853
2019-02-18,14,143,49,47,4242,13,29,37,4574
2019-02-19,18,140,37,48,3852,14,23,41,4173
2019-02-20,17,125,55,47,3902,8,30,49,4233
2019-02-21,19,129,43,44,3568,11,21,27,3862
2019-02-22,15,99,31,27,2369,9,22,34,2606
2019-02-23,5,43,29,28,1673,1,12,22,1813
2019-02-24,11,39,31,26,1932,11,18,23,2091
2019-02-25,0,0,0,0,0,0,0,0,0
2019-02-26,6,43,23,15,2055,3,13,20,2178
2019-02-27,0,0,0,0,0,0,0,0,0
2019-02-28,10,96,27,25,3591,17,31,39,3836
2019-03-01,9,82,29,25,2744,12,14,22,2937
2019-03-02,10,48,26,14,1694,3,16,29,1840
2019-03-03,9,40,20,29,1821,2,12,35,1968
2019-03-04,11,155,40,42,3865,9,22,39,4183
2019-03-05,13,154,52,46,3569,17,18,42,3911
2019-03-06,14,127,31,50,3815,13,25,39,4114
2019-03-07,26,152,66,52,3716,23,24,41,4100
2019-03-08,17,91,44,39,2581,11,19,35,2837
2019-03-09,5,37,27,29,1549,5,17,27,1696
2019-03-10,5,37,34,35,1693,2,11,36,1853
2019-03-11,13,144,48,48,3817,15,20,44,4149
2019-03-12,19,125,68,53,3643,20,21,46,3995
2019-03-13,15,114,52,46,3788,21,33,53,4122
2019-03-14,15,129,44,38,3377,13,24,42,3682
2019-03-15,22,104,40,26,2280,6,22,32,2532
2019-03-16,5,37,30,23,1486,4,11,16,1612
2019-03-17,10,42,31,17,1435,3,10,24,1572
2019-03-18,13,119,50,43,2098,9,23,31,2386
2019-03-19,21,111,36,44,1916,10,13,45,2196
2019-03-20,17,102,36,38,1549,13,21,25,1801
2019-03-21,10,102,40,28,985,4,7,28,1204
2019-03-22,12,93,27,42,693,5,15,28,915
2019-03-23,0,0,0,0,0,0,0,0,0
2019-03-24,0,0,0,0,0,0,0,0,0
2019-03-25,13,118,31,50,526,5,10,25,778
2019-03-26,6,88,29,36,488,6,7,23,683
2019-03-27,9,88,28,44,522,3,8,17,719
2019-03-28,25,91,24,32,456,6,8,23,665
2019-03-29,8,80,22,41,494,3,8,18,674
2019-03-30,0,0,0,0,0,0,0,0,0
2019-03-31,4,9,12,7,642,0,4,5,683
2019-04-01,17,141,50,59,5142,22,17,31,5479
2019-04-02,26,157,47,47,5028,20,19,36,5380
2019-04-03,18,151,59,54,5010,13,36,37,5378
2019-04-04,19,111,42,45,4017,23,28,36,4321
2019-04-05,17,118,56,44,2874,12,27,29,3177
2019-04-06,6,52,31,23,1829,1,4,17,1963
2019-04-07,13,45,34,24,2042,1,10,21,2190
2019-04-08,17,163,57,62,5212,17,36,41,5605
2019-04-09,26,168,61,59,4867,20,39,35,5275
2019-04-10,19,144,64,60,5075,14,42,50,5468
2019-04-11,18,147,60,49,4376,15,36,44,4745
2019-04-12,19,115,44,48,2643,6,24,35,2934
2019-04-13,5,41,28,31,1619,11,21,11,1767
2019-04-14,11,39,28,27,1738,1,16,21,1881
2019-04-15,21,142,58,68,4794,13,33,43,5172
2019-04-16,28,159,63,60,4702,18,36,57,5123
2019-04-17,14,153,61,63,4640,18,37,35,5021
2019-04-18,14,108,40,49,3730,16,27,39,4023
2019-04-19,15,114,44,41,2424,10,27,40,2715
2019-04-20,11,59,23,24,956,2,17,11,1103
2019-04-21,6,29,13,33,1294,1,9,19,1404
2019-04-22,17,152,54,60,4499,18,26,45,4871
2019-04-23,17,147,60,59,4541,26,39,36,4925
2019-04-24,19,164,52,60,4655,17,34,28,5029
2019-04-25,21,149,50,53,3695,18,17,36,4039
2019-04-26,19,108,42,45,2332,6,10,26,2588
2019-04-27,3,47,27,29,1551,0,15,22,1694
2019-04-28,9,39,29,21,1571,2,18,20,1709
2019-04-29,19,158,60,50,4354,19,28,32,4720
2019-04-30,27,143,46,56,4128,15,29,39,4483
2019-05-01,17,140,59,48,4211,15,33,47,4570
2019-05-02,16,148,46,49,3756,19,23,31,4088
2019-05-03,10,98,45,35,2108,6,23,27,2352
2019-05-04,11,36,28,29,1354,0,15,20,1493
2019-05-05,11,36,28,20,1375,1,11,17,1499
2019-05-06,18,173,60,52,4269,14,32,51,4669
2019-05-07,12,170,69,57,4243,23,22,41,4637
2019-05-08,22,143,53,58,4130,15,31,40,4492
2019-05-09,18,141,61,35,3520,15,21,37,3848
2019-05-10,16,92,49,51,2218,10,26,32,2494
2019-05-11,4,37,28,24,1168,0,12,14,1287
2019-05-12,11,34,27,25,1265,1,11,15,1389
2019-05-13,19,150,73,61,3977,17,31,41,4369
2019-05-14,25,162,72,53,3979,15,33,30,4369
2019-05-15,18,144,66,53,4100,21,30,44,4476
2019-05-16,12,145,58,47,3486,13,20,35,3816
2019-05-17,22,115,48,39,2348,7,16,28,2623
2019-05-18,7,46,35,20,1463,1,14,14,1600
2019-05-19,8,39,34,32,1588,2,16,20,1739
2019-05-20,19,137,61,68,4009,18,27,33,4372
2019-05-21,22,148,60,49,3929,20,29,35,4292
2019-05-22,17,129,58,43,4121,14,33,41,4456
2019-05-23,15,145,51,46,3251,18,22,35,3583
2019-05-24,10,93,45,30,2043,6,27,33,2287
2019-05-25,5,35,31,31,1109,1,10,15,1237
2019-05-26,10,33,33,26,1018,2,13,17,1152
2019-05-27,3,46,35,28,1250,0,15,23,1400
2019-05-28,11,155,59,41,3851,15,26,37,4195
2019-05-29,15,121,51,44,3999,20,22,38,4310
2019-05-30,11,145,51,43,3462,14,15,35,3776
2019-05-31,11,85,56,31,2244,6,25,24,2482
2019-06-01,10,40,30,22,1216,0,14,9,1341
2019-06-02,6,31,28,27,1460,3,9,17,1581
2019-06-03,11,149,51,48,3845,13,23,39,4179
2019-06-04,16,149,55,46,3528,16,29,33,3872
2019-06-05,10,117,57,43,3377,16,24,28,3672
2019-06-06,15,134,50,39,3318,11,21,26,3614
2019-06-07,15,90,41,34,2017,2,21,18,2238
2019-06-08,1,44,36,27,1329,1,11,9,1458
2019-06-09,5,31,34,25,1219,0,14,11,1339
2019-06-10,19,120,49,43,1895,8,24,31,2189
2019-06-11,18,116,50,37,1747,8,17,30,2023
2019-06-12,21,116,47,40,1377,1,13,34,1649
2019-06-13,16,104,39,32,894,4,10,36,1135
2019-06-14,11,82,35,33,749,3,9,33,955
2019-06-15,3,21,22,7,299,0,8,4,364
2019-06-16,2,21,9,16,270,0,12,9,339
2019-06-17,10,83,39,20,337,3,4,21,517
2019-06-18,9,87,51,24,473,4,6,23,677
2019-06-19,10,75,36,22,449,4,7,11,614
2019-06-20,18,80,39,27,478,4,10,21,677
2019-06-21,14,56,33,30,417,3,7,21,581
2019-06-22,0,0,0,0,0,0,0,0,0
2019-06-23,0,0,0,0,0,0,0,0,0
2019-06-24,22,104,36,30,630,4,138,19,983
2019-06-25,23,109,32,32,607,19,135,23,980
2019-06-26,26,95,40,33,625,12,153,15,999
2019-06-27,27,87,35,29,537,18,145,16,894
2019-06-28,15,78,36,25,510,8,111,9,792
2019-06-29,12,11,8,12,236,3,67,6,355
2019-06-30,8,16,24,12,204,3,53,11,331
2019-07-01,19,89,47,37,593,14,185,19,1003
2019-07-02,12,111,46,33,544,24,172,20,962
2019-07-03,13,93,39,28,564,17,156,28,938
2019-07-04,0,0,0,0,0,0,0,0,0
2019-07-05,12,45,31,34,376,6,133,18,655
2019-07-06,10,23,23,21,249,8,87,11,432
2019-07-07,14,16,24,19,236,13,99,8,429
2019-07-08,18,106,47,36,594,11,194,19,1025
2019-07-09,13,106,41,33,580,15,210,18,1016
2019-07-10,12,102,33,37,620,21,182,16,1023
2019-07-11,19,98,42,27,565,10,187,14,962
2019-07-12,14,77,36,35,508,6,145,17,838
2019-07-13,7,11,23,18,208,6,64,8,345
2019-07-14,9,16,20,24,237,1,73,7,387
2019-07-15,17,95,41,39,604,12,182,20,1010
2019-07-16,9,124,39,36,587,28,207,23,1053
2019-07-17,9,97,44,41,543,20,183,20,957
2019-07-18,23,108,43,32,473,19,156,18,872
2019-07-19,6,66,29,45,468,9,160,18,801
2019-07-20,2,19,19,21,195,5,79,2,342
2019-07-21,7,18,12,19,199,6,76,5,342
2019-07-22,6,117,48,47,564,15,212,25,1034
2019-07-23,13,112,39,39,556,20,196,24,999
2019-07-24,17,100,48,36,533,15,180,19,948
2019-07-25,8,98,31,42,452,14,183,19,847
2019-07-26,10,95,32,31,370,15,179,17,749
2019-07-27,2,18,19,19,194,4,68,5,329
2019-07-28,6,15,19,13,200,6,75,7,341
2019-07-29,13,111,51,44,566,20,204,25,1034
2019-07-30,16,114,44,33,510,19,200,24,960
2019-07-31,11,111,45,35,469,16,181,18,886
2019-08-01,12,118,35,37,444,16,178,25,865
2019-08-02,10,105,30,41,400,8,160,23,777
2019-08-03,3,23,19,13,206,9,68,10,351
2019-08-04,4,21,15,20,220,8,78,7,373
2019-08-05,9,118,41,43,484,19,227,26,967
2019-08-06,12,113,43,41,468,13,191,21,902
2019-08-07,11,98,33,42,464,14,193,22,877
2019-08-08,10,79,35,33,428,12,154,24,775
2019-08-09,11,88,28,42,340,8,157,22,696
2019-08-10,1,17,21,15,208,6,73,4,345
2019-08-11,5,29,18,20,200,3,89,11,375
2019-08-12,13,113,44,42,458,16,211,19,916
2019-08-13,10,107,43,34,396,11,169,22,792
2019-08-14,10,113,36,39,396,14,177,17,802
2019-08-15,16,103,41,34,328,9,151,26,708
2019-08-16,7,84,36,28,339,10,151,23,678
2019-08-17,0,21,22,16,151,5,71,1,287
2019-08-18,0,22,20,20,173,5,78,8,326
2019-08-19,14,103,41,35,340,18,156,18,725
2019-08-20,16,105,49,43,381,13,167,21,795
2019-08-21,9,95,38,40,314,19,157,15,687
2019-08-22,16,88,42,35,305,13,141,16,656
2019-08-23,7,79,39,43,302,9,142,14,635
2019-08-24,0,0,0,0,0,0,0,0,0
2019-08-25,0,0,0,0,0,0,0,0,0
2019-08-26,0,0,0,0,0,0,0,0,0
2019-08-27,0,0,0,0,0,0,0,0,0
2019-08-28,0,0,0,0,0,0,0,0,0
2019-08-29,0,0,0,0,0,0,0,0,0
2019-08-30,0,0,0,0,0,0,0,0,0
2019-08-31,0,0,0,0,0,0,0,0,0
2019-09-01,0,0,0,0,0,0,0,0,0
2019-09-02,0,0,0,0,0,0,0,0,0
2019-09-03,0,0,0,0,0,9,0,0,9
2019-09-04,0,0,0,0,0,0,0,0,0
2019-09-05,0,0,0,0,0,1,0,0,1
2019-09-06,0,0,0,0,0,4,0,0,4
2019-09-07,0,0,0,0,0,0,0,0,0
2019-09-08,0,0,0,0,0,0,0,0,0
2019-09-09,11,108,40,46,331,13,141,24,714
2019-09-10,13,89,30,28,332,7,153,11,663
2019-09-11,11,98,25,39,306,14,130,15,638
2019-09-12,10,81,23,25,287,18,125,16,585
2019-09-13,10,67,29,33,213,6,88,14,460
2019-09-14,0,0,0,0,0,0,0,0,0
2019-09-15,0,0,0,0,0,0,0,0,0
2019-09-16,14,102,33,40,628,10,128,16,971
2019-09-17,11,114,39,43,620,15,133,26,1001
2019-09-18,14,97,31,29,685,23,92,18,989
2019-09-19,10,85,32,34,669,23,103,20,976
2019-09-20,10,71,37,37,700,18,109,20,1002
2019-09-21,0,0,0,0,0,0,0,0,0
2019-09-22,0,0,0,0,0,0,0,0,0
2019-09-23,20,126,37,43,1542,25,138,30,1961
2019-09-24,14,106,42,31,1358,26,119,29,1725
2019-09-25,8,98,30,36,1371,10,106,16,1675
2019-09-26,5,95,38,26,1442,18,101,21,1746
2019-09-27,7,70,26,38,1358,6,80,23,1608
2019-09-28,6,23,27,18,1794,6,53,14,1941
2019-09-29,3,19,12,7,2269,3,48,11,2372
2019-09-30,15,189,46,42,4232,17,16,30,4587
2019-10-01,22,210,46,50,5348,15,8,24,5723
2019-10-02,21,203,51,45,4962,22,12,29,5345
2019-10-03,18,191,49,34,4257,14,7,32,4602
2019-10-04,13,147,39,51,3110,10,7,30,3407
2019-10-05,6,36,12,23,1253,2,2,8,1342
2019-10-06,9,35,18,29,1782,1,5,13,1892
2019-10-07,16,213,44,51,4883,21,6,37,5271
2019-10-08,27,203,56,45,4365,8,8,34,4746
2019-10-09,18,193,40,53,4336,14,13,32,4699
2019-10-10,13,190,46,46,3601,11,11,36,3954
2019-10-11,14,152,34,41,1866,4,10,23,2144
2019-10-12,1,54,23,25,1471,3,7,15,1599
2019-10-13,10,50,24,22,1632,1,6,18,1763
2019-10-14,8,205,47,62,3991,12,7,31,4363
2019-10-15,20,176,56,59,3767,12,9,29,4128
2019-10-16,19,195,43,45,3879,14,17,36,4248
2019-10-17,13,190,40,40,3430,14,8,39,3774
2019-10-18,13,136,32,43,2283,8,11,28,2554
2019-10-19,8,36,31,27,1439,3,4,14,1562
2019-10-20,5,64,37,25,1664,2,6,25,1828
2019-10-21,9,228,51,61,4103,25,11,35,4523
2019-10-22,23,191,60,42,3885,17,13,46,4277
2019-10-23,8,188,41,37,3842,23,14,43,4196
2019-10-24,16,176,41,39,3281,21,15,35,3624
2019-10-25,13,137,31,28,2284,14,8,32,2547
2019-10-26,3,51,27,22,1017,0,5,17,1142
2019-10-27,2,48,26,17,1397,1,4,11,1506
2019-10-28,17,202,58,51,3906,21,11,38,4304
2019-10-29,21,190,59,42,3743,18,12,35,4120
2019-10-30,15,201,50,48,3471,14,16,35,3850
2019-10-31,8,166,45,39,2824,21,10,26,3139
2019-11-01,13,143,39,28,1894,19,9,30,2175
2019-11-02,4,34,30,24,1322,4,6,15,1439
2019-11-03,8,50,40,23,1725,7,4,16,1873
2019-11-04,27,232,60,51,4106,27,10,45,4558
2019-11-05,24,196,66,50,3833,20,14,39,4242
2019-11-06,21,221,56,53,4023,30,17,38,4459
2019-11-07,16,188,57,44,3585,14,12,34,3950
2019-11-08,16,175,51,48,2349,14,11,21,2685
2019-11-09,5,39,36,30,1374,1,9,13,1507
2019-11-10,12,60,29,23,1647,1,10,21,1803
2019-11-11,18,215,54,54,4028,14,14,39,4436
2019-11-12,20,204,62,55,3916,14,9,36,4316
2019-11-13,12,201,60,62,3946,22,16,40,4359
2019-11-14,16,176,79,48,3421,19,9,31,3799
2019-11-15,24,143,54,37,2456,16,8,21,2759
2019-11-16,4,51,23,25,1165,5,6,18,1297
2019-11-17,10,50,39,19,1555,1,10,19,1703
2019-11-18,22,215,51,54,4193,15,12,35,4597
2019-11-19,26,220,72,50,3881,17,14,34,4314
2019-11-20,19,191,50,52,4019,21,10,35,4397
2019-11-21,13,167,55,33,3628,19,14,34,3963
2019-11-22,16,161,44,49,2235,5,8,27,2545
2019-11-23,4,47,33,23,1549,6,5,19,1686
2019-11-24,13,61,33,25,1802,1,10,23,1968
2019-11-25,14,222,64,55,3568,19,9,37,3988
2019-11-26,23,178,59,49,2743,12,7,30,3101
2019-11-27,14,159,43,45,1495,16,4,23,1799
2019-11-28,0,0,0,0,0,0,0,0,0
2019-11-29,0,0,0,0,0,0,0,0,0
2019-11-30,0,0,0,0,0,0,0,0,0
2019-12-01,14,51,35,28,1150,0,4,21,1303
2019-12-02,10,231,58,57,3666,19,11,39,4091
2019-12-03,22,199,64,46,3451,19,17,32,3850
2019-12-04,16,181,53,45,3551,28,8,30,3912
2019-12-05,7,144,48,32,3195,27,10,26,3489
2019-12-06,16,153,42,35,2040,14,6,20,2326
2019-12-07,4,43,29,24,1526,1,2,11,1640
2019-12-08,12,54,31,21,1459,2,7,11,1597
2019-12-09,22,192,49,45,2156,16,4,27,2511
2019-12-10,12,171,56,34,1802,15,8,20,2118
2019-12-11,18,160,48,35,1552,16,5,31,1865
2019-12-12,13,144,46,27,970,11,7,22,1240
2019-12-13,21,154,33,40,764,8,7,19,1046
2019-12-14,0,0,0,0,0,0,0,0,0
2019-12-15,0,0,0,0,0,0,0,0,0
2019-12-16,15,125,21,10,387,11,2,17,588
2019-12-17,13,138,27,22,340,2,1,14,557
2019-12-18,23,124,25,26,319,13,0,19,549
2019-12-19,13,111,34,20,293,9,2,13,495
2019-12-20,24,101,27,25,219,11,1,16,424
2019-12-21,0,0,0,0,0,0,0,0,0
2019-12-22,0,0,0,0,0,0,0,0,0
2019-12-23,0,0,0,0,0,0,0,0,0
2019-12-24,0,0,0,0,0,0,0,0,0
2019-12-25,0,0,0,0,0,0,0,0,0
2019-12-26,16,59,23,14,162,3,0,12,289
2019-12-27,8,76,25,24,188,8,0,10,339
2019-12-28,0,0,0,0,0,0,0,0,0
2019-12-29,0,0,0,0,0,0,0,0,0
2019-12-30,0,0,0,0,0,0,0,0,0
2019-12-31,0,0,0,0,0,0,0,0,0
2020-01-01,0,0,0,0,0,0,0,0,0
2020-01-02,13,149,21,27,332,5,0,21,568
2020-01-03,20,126,22,28,441,4,0,28,669
2020-01-04,0,0,0,0,0,0,0,0,0
2020-01-05,2,21,12,10,825,2,1,8,881
2020-01-06,22,231,61,63,5017,19,6,36,5455
2020-01-07,18,219,65,48,4889,11,11,37,5298
2020-01-08,12,236,57,53,4931,20,12,39,5360
2020-01-09,25,195,66,33,4000,21,5,40,4385
2020-01-10,24,171,55,47,2865,10,11,33,3216
2020-01-11,12,64,33,21,1828,2,6,20,1986
2020-01-12,11,70,37,24,1923,1,4,21,2091
2020-01-13,22,274,69,47,4930,21,12,47,5422
2020-01-14,21,247,79,45,4884,13,11,42,5342
2020-01-15,13,214,59,49,4435,23,16,43,4852
2020-01-16,22,206,72,34,4085,11,11,44,4485
2020-01-17,19,177,59,36,2466,14,17,41,2829
2020-01-18,6,58,49,19,1583,8,5,25,1753
2020-01-19,8,44,45,24,1378,0,2,12,1513
2020-01-20,12,87,43,52,1886,2,9,24,2115
2020-01-21,20,228,67,50,4803,15,16,50,5249
2020-01-22,22,244,74,45,4847,15,15,33,5295
2020-01-23,15,212,65,32,4116,19,10,48,4517
2020-01-24,24,192,51,37,2771,13,16,32,3136
2020-01-25,5,55,41,22,1729,1,5,19,1877
2020-01-26,10,67,40,25,2325,3,9,24,2503
2020-01-27,23,252,66,50,4638,20,13,40,5102
2020-01-28,20,238,74,42,4556,13,10,49,5002
2020-01-29,15,226,57,46,4476,20,19,42,4901
2020-01-30,16,200,56,39,4032,18,11,39,4411
2020-01-31,15,170,55,36,2490,11,13,24,2814
2020-02-01,9,72,41,24,2259,3,12,25,2445
2020-02-02,9,50,33,22,1493,0,4,12,1623
2020-02-03,13,211,61,41,4487,14,16,45,4888
2020-02-04,20,207,65,43,4504,16,16,46,4917
2020-02-05,20,197,68,55,4454,9,14,44,4861
2020-02-06,23,195,63,42,4082,14,22,47,4488
2020-02-07,9,163,72,43,2404,7,15,30,2743
2020-02-08,6,57,39,17,1702,5,10,12,1848
2020-02-09,7,57,36,24,2062,2,9,30,2227
2020-02-10,24,214,65,51,4465,12,15,40,4886
2020-02-11,22,215,64,55,4373,17,25,49,4820
2020-02-12,12,203,78,49,4433,15,17,31,4838
2020-02-13,15,200,62,37,3646,15,15,31,4021
2020-02-14,17,130,51,36,2142,8,12,33,2429
2020-02-15,5,56,37,25,1489,1,11,21,1645
2020-02-16,11,51,42,19,1933,2,7,9,2074
2020-02-17,11,204,60,43,4266,16,15,32,4647
2020-02-18,23,225,76,47,4365,14,16,47,4813
2020-02-19,11,204,69,40,4169,17,15,33,4558
2020-02-20,23,185,70,39,3666,37,15,40,4075
2020-02-21,14,179,61,48,2142,9,12,26,2491
2020-02-22,3,59,36,23,1367,3,6,17,1514
2020-02-23,7,60,41,37,2060,1,4,18,2228
2020-02-24,9,244,65,57,4185,18,15,45,4638
2020-02-25,20,219,76,44,3861,11,11,39,4281
2020-02-26,17,206,75,53,4314,15,16,49,4745
2020-02-27,19,201,62,42,3562,19,10,32,3947
2020-02-28,12,135,55,39,2121,6,12,35,2415
2020-02-29,8,67,42,24,1533,5,8,21,1708
2020-03-01,6,41,47,34,1915,1,9,14,2067
2020-03-02,13,217,63,48,4185,23,16,36,4601
2020-03-03,12,194,72,53,4151,17,15,38,4552
2020-03-04,10,181,60,54,4033,16,15,30,4399
2020-03-05,13,175,58,39,3613,15,9,30,3952
2020-03-06,15,144,50,47,2343,11,12,29,2651
2020-03-07,6,48,27,28,1812,3,13,10,1947
2020-03-08,5,54,46,25,1652,0,7,12,1801
2020-03-09,11,186,58,39,3870,17,15,29,4225
2020-03-10,13,198,61,43,3565,15,10,26,3931
2020-03-11,9,163,46,48,3389,20,14,20,3709
2020-03-12,15,142,51,31,2440,10,11,21,2721
2020-03-13,5,114,40,28,1468,11,7,12,1685
2020-03-14,4,44,25,15,921,3,6,8,1026
2020-03-15,5,34,29,15,783,2,3,5,876
2020-03-16,8,96,31,34,820,9,4,13,1015
2020-03-17,6,89,25,28,623,4,7,8,790
2020-03-18,0,0,0,0,0,0,0,0,0
2020-03-19,0,0,0,0,0,0,0,0,0
2020-03-20,0,0,0,0,0,0,0,0,0
2020-03-21,0,0,0,0,0,0,0,0,0
2020-03-22,0,0,0,0,0,0,0,0,0
2020-03-23,0,0,0,0,0,0,0,0,0
2020-03-24,0,0,0,0,0,0,0,0,0
2020-03-25,0,0,0,0,0,0,0,0,0
2020-03-26,0,0,0,0,0,0,0,0,0
2020-03-27,0,0,0,0,0,0,0,0,0
2020-03-28,0,0,0,0,0,0,0,0,0
2020-03-29,0,0,0,0,0,0,0,0,0
2020-03-30,0,0,0,0,0,0,0,0,0
2020-03-31,0,0,0,0,0,0,0,0,0
2020-04-01,0,0,0,0,0,0,0,0,0
2020-04-02,0,0,0,0,0,0,0,0,0
2020-04-03,0,0,0,0,0,0,0,0,0
2020-04-04,0,0,0,0,0,0,0,0,0
2020-04-05,0,0,0,0,0,0,0,0,0
2020-04-06,0,0,0,0,0,0,0,0,0
2020-04-07,0,0,0,0,0,0,0,0,0
2020-04-08,0,0,0,0,0,0,0,0,0
2020-04-09,0,0,0,0,0,0,0,0,0
2020-04-10,0,0,0,0,0,0,0,0,0
2020-04-11,0,0,0,0,0,0,0,0,0
2020-04-12,0,0,0,0,0,0,0,0,0
2020-04-13,0,0,0,0,0,0,0,0,0
2020-04-14,0,0,0,0,0,0,0,0,0
2020-04-15,0,0,0,0,0,0,0,0,0
2020-04-16,0,0,0,0,0,0,0,0,0
2020-04-17,0,0,0,0,0,0,0,0,0
2020-04-18,0,0,0,0,0,0,0,0,0
2020-04-19,0,0,0,0,0,0,0,0,0
2020-04-20,0,0,0,0,0,0,0,0,0
2020-04-21,0,0,0,0,0,0,0,0,0
2020-04-22,0,0,0,0,0,0,0,0,0
2020-04-23,0,0,0,0,0,0,0,0,0
2020-04-24,0,0,0,0,0,0,0,0,0
2020-04-25,0,0,0,0,0,0,0,0,0
2020-04-26,0,0,0,0,0,0,0,0,0
2020-04-27,0,0,0,0,0,0,0,0,0
2020-04-28,0,0,0,0,0,0,0,0,0
2020-04-29,0,0,0,0,0,0,0,0,0
2020-04-30,0,0,0,0,0,0,0,0,0
2020-05-01,0,0,0,0,0,0,0,0,0
2020-05-02,0,0,0,0,0,0,0,0,0
2020-05-03,0,0,0,0,0,0,0,0,0
2020-05-04,0,0,0,0,0,0,0,0,0
2020-05-05,0,0,0,0,0,0,0,0,0
2020-05-06,0,0,0,0,0,0,0,0,0
2020-05-07,0,0,0,0,0,0,0,0,0
2020-05-08,0,0,0,0,0,0,0,0,0
2020-05-09,0,0,0,0,0,0,0,0,0
2020-05-10,0,0,0,0,0,0,0,0,0
2020-05-11,0,0,0,0,0,0,0,0,0
2020-05-12,0,0,0,0,0,0,0,0,0
2020-05-13,0,0,0,0,0,0,0,0,0
2020-05-14,0,0,0,0,0,0,0,0,0
2020-05-15,0,0,0,0,0,0,0,0,0
2020-05-16,0,0,0,0,0,0,0,0,0
2020-05-17,0,0,0,0,0,0,0,0,0
2020-05-18,0,0,0,0,0,0,0,0,0
2020-05-19,0,0,0,0,0,0,0,0,0
2020-05-20,0,0,0,0,0,0,0,0,0
2020-05-21,0,0,0,0,0,0,0,0,0
2020-05-22,0,0,0,0,0,0,0,0,0
2020-05-23,0,0,0,0,0,0,0,0,0
2020-05-24,0,0,0,0,0,0,0,0,0
2020-05-25,0,0,0,0,0,0,0,0,0
2020-05-26,0,0,0,0,0,0,0,0,0
2020-05-27,0,0,0,0,0,0,0,0,0
2020-05-28,0,0,0,0,0,0,0,0,0
2020-05-29,0,0,0,0,0,0,0,0,0
2020-05-30,0,0,0,0,0,0,0,0,0
2020-05-31,0,0,0,0,0,0,0,0,0
2020-06-01,0,0,0,0,0,0,0,0,0
2020-06-02,0,0,0,0,0,0,0,0,0
2020-06-03,0,0,0,0,0,0,0,0,0
2020-06-04,0,0,0,0,0,0,0,0,0
2020-06-05,0,0,0,0,0,0,0,0,0
2020-06-06,0,0,0,0,0,0,0,0,0
2020-06-07,0,0,0,0,0,0,0,0,0
2020-06-08,0,0,0,0,0,0,0,0,0
2020-06-09,0,0,0,0,0,0,0,0,0
2020-06-10,0,0,0,0,0,0,0,0,0
2020-06-11,0,0,0,0,0,0,0,0,0
2020-06-12,0,0,0,0,0,0,0,0,0
2020-06-13,0,0,0,0,0,0,0,0,0
2020-06-14,0,0,0,0,0,0,0,0,0
2020-06-15,0,0,0,0,0,0,0,0,0
2020-06-16,0,0,0,0,0,0,0,0,0
2020-06-17,0,0,0,0,0,0,0,0,0
2020-06-18,0,0,0,0,0,0,0,0,0
2020-06-19,0,0,0,0,0,0,0,0,0
2020-06-20,0,0,0,0,0,0,0,0,0
2020-06-21,0,0,0,0,0,0,0,0,0
2020-06-22,0,0,0,0,0,0,0,0,0
2020-06-23,0,0,0,0,0,0,0,0,0
2020-06-24,0,0,0,0,0,0,0,0,0
2020-06-25,0,0,0,0,0,0,0,0,0
2020-06-26,0,0,0,0,0,0,0,0,0
2020-06-27,0,0,0,0,0,0,0,0,0
2020-06-28,0,0,0,0,0,0,0,0,0
2020-06-29,0,0,0,0,0,0,0,0,0
2020-06-30,0,0,0,0,0,0,0,0,0
2020-07-01,0,0,0,0,0,0,0,0,0
2020-07-02,0,0,0,0,0,0,0,0,0
2020-07-03,0,0,0,0,0,0,0,0,0
2020-07-04,0,0,0,0,0,0,0,0,0
2020-07-05,0,0,0,0,0,0,0,0,0
2020-07-06,0,0,0,0,0,0,0,0,0
2020-07-07,0,0,0,0,0,0,0,0,0
2020-07-08,0,0,0,0,0,0,0,0,0
2020-07-09,0,0,0,0,0,0,0,0,0
2020-07-10,0,0,0,0,0,0,0,0,0
2020-07-11,0,0,0,0,0,0,0,0,0
2020-07-12,0,0,0,0,0,0,0,0,0
2020-07-13,0,0,0,0,0,0,0,0,0
2020-07-14,0,0,0,0,0,0,0,0,0
2020-07-15,0,0,0,0,0,0,0,0,0
2020-07-16,0,0,0,0,0,0,0,0,0
2020-07-17,0,0,0,0,0,0,0,0,0
2020-07-18,0,0,0,0,0,0,0,0,0
2020-07-19,0,0,0,0,0,0,0,0,0
2020-07-20,0,0,0,0,0,0,0,0,0
2020-07-21,0,0,0,0,0,0,0,0,0
2020-07-22,0,0,0,0,0,0,0,0,0
2020-07-23,0,0,0,0,0,0,0,0,0
2020-07-24,0,0,0,0,0,0,0,0,0
2020-07-25,0,0,0,0,0,0,0,0,0
2020-07-26,0,0,0,0,0,0,0,0,0
2020-07-27,0,0,0,0,0,0,0,0,0
2020-07-28,0,0,0,0,0,0,0,0,0
2020-07-29,0,0,0,0,0,0,0,0,0
2020-07-30,0,0,0,0,0,0,0,0,0
2020-07-31,0,0,0,0,0,0,0,0,0
2020-08-01,0,0,0,0,0,0,0,0,0
2020-08-02,0,0,0,0,0,0,0,0,0
2020-08-03,0,0,0,0,0,0,0,0,0
2020-08-04,0,0,0,0,0,0,0,0,0
2020-08-05,0,0,0,0,0,0,0,0,0
2020-08-06,0,0,0,0,0,0,0,0,0
2020-08-07,0,0,0,0,0,0,0,0,0
2020-08-08,0,0,0,0,0,0,0,0,0
2020-08-09,0,0,0,0,0,0,0,0,0
2020-08-10,0,0,0,0,0,0,0,0,0
2020-08-11,0,0,0,0,0,0,0,0,0
2020-08-12,0,0,0,0,0,0,0,0,0
2020-08-13,0,0,0,0,0,0,0,0,0
2020-08-14,0,0,0,0,0,0,0,0,0
2020-08-15,0,0,0,0,0,0,0,0,0
2020-08-16,0,0,0,0,0,0,0,0,0
2020-08-17,0,0,0,0,0,0,0,0,0
2020-08-18,0,0,0,0,0,0,0,0,0
2020-08-19,0,0,0,0,0,0,0,0,0
2020-08-20,0,0,0,0,0,0,0,0,0
2020-08-21,0,0,0,0,0,0,0,0,0
2020-08-22,0,0,0,0,0,0,0,0,0
2020-08-23,0,0,0,0,0,0,0,0,0
2020-08-24,0,0,0,0,0,0,0,0,0
2020-08-25,0,0,0,0,0,0,0,0,0
2020-08-26,0,0,0,0,0,0,0,0,0
2020-08-27,0,0,0,0,0,0,0,0,0
2020-08-28,0,0,0,0,0,0,0,0,0
2020-08-29,0,0,0,0,0,0,0,0,0
2020-08-30,0,0,0,0,0,0,0,0,0
2020-08-31,0,0,0,0,0,0,0,0,0
2020-09-01,0,0,0,0,0,2,0,0,2
2020-09-02,0,0,0,0,0,0,0,0,0
2020-09-03,0,0,0,0,0,0,0,0,0
2020-09-04,0,0,0,0,1,0,0,0,1
2020-09-05,0,0,0,0,0,0,0,0,0
2020-09-06,0,0,0,0,0,0,0,0,0
2020-09-07,0,0,0,0,0,0,0,0,0
2020-09-08,0,0,0,0,0,0,0,0,0
2020-09-09,0,0,0,0,3,0,0,0,3
2020-09-10,0,0,0,0,0,13,0,0,13
2020-09-11,0,0,0,0,4,4,0,0,8
2020-09-12,0,0,0,0,0,0,0,0,0
2020-09-13,0,0,0,0,0,0,0,0,0
2020-09-14,0,0,0,0,0,0,0,0,0
2020-09-15,0,0,0,0,5,0,0,0,5
2020-09-16,0,0,0,0,11,0,0,0,11
2020-09-17,0,0,0,0,7,30,0,0,37
2020-09-18,0,0,0,0,1,1,0,0,2
2020-09-19,0,0,0,0,0,0,0,0,0
2020-09-20,0,0,0,0,0,0,0,0,0
2020-09-21,13,0,0,0,720,10,0,0,743
2020-09-22,17,0,0,0,819,7,0,0,843
2020-09-23,27,4,0,0,897,3,0,0,931
2020-09-24,23,0,0,0,1033,5,0,0,1061
2020-09-25,24,2,0,1,1031,8,0,0,1066
2020-09-26,11,0,0,0,1021,1,0,0,1033
2020-09-27,9,0,0,0,888,3,0,2,902
2020-09-28,27,1,0,1,1784,4,0,0,1817
2020-09-29,33,1,0,1,1866,5,0,0,1906
2020-09-30,31,2,0,1,1778,3,0,0,1815
2020-10-01,30,1,0,0,1598,2,0,0,1631
2020-10-02,34,1,0,1,1372,3,0,0,1411
2020-10-03,10,0,0,0,886,3,0,1,900
2020-10-04,15,0,0,0,765,1,0,0,781
2020-10-05,37,2,0,0,1764,1,0,0,1804
2020-10-06,31,1,0,1,1730,2,0,0,1765
2020-10-07,30,2,0,0,1482,4,0,0,1518
2020-10-08,34,2,0,0,1537,3,0,0,1576
2020-10-09,37,2,0,0,1202,1,0,1,1243
2020-10-10,19,0,0,0,710,0,0,0,729
2020-10-11,19,0,0,1,662,2,0,0,684
2020-10-12,44,2,0,0,1590,1,0,0,1637
2020-10-13,45,1,0,1,1551,4,0,1,1603
2020-10-14,34,2,0,0,1377,4,0,1,1418
2020-10-15,29,1,0,0,1410,3,0,1,1444
2020-10-16,35,4,0,0,1222,2,0,1,1264
2020-10-17,9,0,0,0,689,0,0,0,698
2020-10-18,19,0,0,0,680,1,0,0,700
2020-10-19,39,2,0,0,1658,4,0,1,1704
2020-10-20,41,1,0,0,1708,2,0,1,1753
2020-10-21,26,2,0,0,1476,3,0,0,1507
2020-10-22,34,1,0,0,1399,3,0,1,1438
2020-10-23,29,1,0,0,1153,1,0,1,1185
2020-10-24,14,0,0,0,739,0,0,0,753
2020-10-25,13,0,0,0,660,1,0,0,674
2020-10-26,26,2,0,0,1578,2,0,1,1609
2020-10-27,35,1,0,0,1650,1,0,1,1688
2020-10-28,34,2,0,0,1515,2,0,1,1554
2020-10-29,27,1,0,0,1380,2,0,1,1411
2020-10-30,28,2,0,0,1107,0,0,1,1138
2020-10-31,16,0,0,0,646,1,0,0,663
2020-11-01,11,0,0,0,492,1,0,0,504
2020-11-02,35,2,0,0,1640,0,0,0,1677
2020-11-03,30,1,0,0,1746,0,0,1,1778
2020-11-04,26,1,0,0,1512,2,0,0,1541
2020-11-05,34,3,0,0,1564,1,0,0,1602
2020-11-06,37,1,0,0,1345,3,0,0,1386
2020-11-07,13,0,0,0,669,0,0,0,682
2020-11-08,14,0,0,0,697,0,0,0,711
2020-11-09,33,1,0,0,1712,0,0,1,1747
2020-11-10,37,1,0,0,1783,0,0,0,1821
2020-11-11,27,2,0,0,1509,2,0,1,1541
2020-11-12,33,1,0,0,1574,3,0,0,1611
2020-11-13,29,2,0,0,1272,1,0,1,1305
2020-11-14,12,0,0,0,697,1,0,0,710
2020-11-15,17,0,0,0,736,2,0,0,755
2020-11-16,29,2,0,0,1513,0,0,1,1545
2020-11-17,25,2,0,0,1542,2,0,1,1572
2020-11-18,0,0,0,0,0,0,0,0,0
2020-11-19,0,0,0,0,0,0,0,0,0
2020-11-20,0,0,0,0,0,0,0,0,0
2020-11-21,0,0,0,0,0,0,0,0,0
2020-11-22,0,0,0,0,0,0,0,0,0
2020-11-23,0,0,0,0,1,0,0,0,1
2020-11-24,0,0,0,0,1,0,0,0,1
2020-11-25,0,0,0,0,0,0,0,0,0
2020-11-26,0,0,0,0,0,0,0,0,0
2020-11-27,0,0,0,0,0,0,0,0,0
2020-11-28,0,0,0,0,0,0,0,0,0
2020-11-29,0,0,0,0,0,0,0,0,0
2020-11-30,0,0,0,0,0,0,0,0,0
2020-12-01,0,0,0,0,0,0,0,0,0
2020-12-02,0,0,0,0,0,0,0,0,0
2020-12-03,0,0,0,0,0,0,0,0,0
2020-12-04,0,0,0,0,0,0,0,0,0
2020-12-05,0,0,0,0,0,0,0,0,0
2020-12-06,0,0,0,0,0,0,0,0,0
2020-12-07,0,0,0,0,1,0,0,0,1
2020-12-08,0,0,0,0,0,0,0,0,0
2020-12-09,0,1,0,0,0,0,0,0,1
2020-12-10,0,0,0,0,0,0,0,0,0
2020-12-11,0,0,0,0,0,0,0,0,0
2020-12-12,0,0,0,0,0,0,0,0,0
2020-12-13,0,0,0,0,0,0,0,0,0
2020-12-14,0,0,0,0,0,0,0,0,0
2020-12-15,0,0,0,0,0,0,0,0,0
2020-12-16,0,0,0,0,0,0,0,0,0
2020-12-17,0,0,0,0,0,0,0,0,0
2020-12-18,0,0,0,0,0,0,0,0,0
2020-12-19,0,0,0,0,0,0,0,0,0
2020-12-20,0,0,0,0,0,0,0,0,0
2020-12-21,0,0,0,0,0,0,0,0,0
2020-12-22,0,0,0,0,0,0,0,0,0
2020-12-23,0,0,0,0,0,0,0,0,0
2020-12-24,0,0,0,0,0,0,0,0,0
2020-12-25,0,0,0,0,0,0,0,0,0
2020-12-26,0,0,0,0,0,0,0,0,0
2020-12-27,0,0,0,0,0,0,0,0,0
2020-12-28,0,0,0,0,0,0,0,0,0
2020-12-29,0,0,0,0,0,0,0,0,0
2020-12-30,0,0,0,0,0,0,0,0,0
2020-12-31,0,0,0,0,0,0,0,0,0
2021-01-01,0,0,0,0,0,0,0,0,0
2021-01-02,0,0,0,0,0,0,0,0,0
2021-01-03,0,0,0,0,0,0,0,0,0
2021-01-04,0,0,0,0,0,0,0,0,0
2021-01-05,0,0,0,0,0,0,0,0,0
2021-01-06,0,0,0,0,0,0,0,0,0
2021-01-07,0,0,0,0,0,0,0,0,0
2021-01-08,0,0,0,0,1,1,0,0,2
2021-01-09,0,0,0,0,0,0,0,0,0
2021-01-10,0,0,0,0,0,0,0,0,0
2021-01-11,0,0,0,0,268,0,0,1,269
2021-01-12,0,0,0,0,343,1,0,2,346
2021-01-13,0,0,0,0,255,0,0,0,255
2021-01-14,1,0,0,0,352,1,0,0,354
2021-01-15,0,0,0,0,240,1,0,0,241
2021-01-16,0,0,0,0,158,0,0,0,158
2021-01-17,0,0,0,0,146,0,0,0,146
2021-01-18,0,0,0,0,222,0,0,1,223
2021-01-19,1,0,0,0,323,2,0,2,328
2021-01-20,0,0,0,0,290,0,0,1,291
2021-01-21,0,0,0,0,383,2,0,0,385
2021-01-22,0,0,0,0,274,1,0,0,275
2021-01-23,0,0,0,0,169,0,0,0,169
2021-01-24,0,0,0,0,142,0,0,0,142
2021-01-25,0,0,0,0,336,0,0,1,337
2021-01-26,1,0,0,0,360,3,0,1,365
2021-01-27,0,0,0,0,313,1,0,1,315
2021-01-28,1,0,0,0,404,2,0,0,407
2021-01-29,0,0,0,0,284,1,0,0,285
2021-01-30,0,0,0,0,182,0,0,0,182
2021-01-31,0,0,0,0,190,0,0,0,190
2021-02-01,0,0,0,0,306,1,0,1,308
2021-02-02,1,0,0,0,435,3,0,1,440
2021-02-03,0,0,0,0,417,0,0,1,418
2021-02-04,0,0,0,0,436,3,0,1,440
2021-02-05,0,0,0,0,327,2,0,0,329
2021-02-06,0,0,0,0,203,0,0,0,203
2021-02-07,0,0,0,0,156,0,0,0,156
2021-02-08,0,0,0,0,347,1,0,1,349
2021-02-09,1,0,0,0,399,3,0,2,405
2021-02-10,0,0,0,0,359,1,0,1,361
2021-02-11,1,0,0,0,403,4,0,1,409
2021-02-12,0,0,0,0,292,5,0,0,297
2021-02-13,0,0,0,0,231,0,0,0,231
2021-02-14,0,0,0,0,148,0,0,0,148
2021-02-15,0,0,0,0,343,1,0,1,345
2021-02-16,1,0,0,0,393,2,0,2,398
2021-02-17,0,0,0,0,379,1,0,1,381
2021-02-18,0,0,0,0,395,2,0,2,399
2021-02-19,0,0,0,0,321,1,0,0,322
2021-02-20,0,0,0,0,228,1,0,0,229
2021-02-21,0,0,0,0,168,0,0,0,168
2021-02-22,0,0,0,0,380,1,0,1,382
2021-02-23,0,0,0,0,427,4,0,3,434
2021-02-24,0,0,0,0,375,1,0,1,377
2021-02-25,0,0,0,0,427,3,0,2,432
2021-02-26,0,0,0,0,11,0,0,0,11
2021-02-27,0,0,0,0,0,0,0,0,0
2021-02-28,0,0,0,0,0,0,0,0,0
2021-03-01,0,0,0,0,932,1,0,1,934
2021-03-02,0,0,0,0,976,2,0,2,980
2021-03-03,0,0,0,0,971,1,0,1,973
2021-03-04,0,0,0,0,982,1,0,2,985
2021-03-05,0,0,0,0,860,3,0,0,863
2021-03-06,0,0,0,0,436,0,0,0,436
2021-03-07,0,0,0,0,390,0,0,0,390
2021-03-08,0,0,0,0,1045,2,0,1,1048
2021-03-09,0,0,0,0,1074,3,0,3,1080
2021-03-10,1,0,0,0,1034,3,0,1,1039
2021-03-11,0,0,0,0,1023,3,0,2,1028
2021-03-12,0,0,0,0,809,2,1,1,813
2021-03-13,1,0,0,0,447,0,0,0,448
2021-03-14,0,0,0,0,476,2,0,0,478
2021-03-15,0,0,0,0,960,1,1,1,963
2021-03-16,0,0,0,0,819,0,0,2,821
2021-03-17,0,0,0,0,702,0,0,1,703
2021-03-18,0,0,0,0,500,2,0,1,503
2021-03-19,0,0,0,0,396,0,0,1,397
2021-03-20,0,0,0,0,0,0,0,0,0
2021-03-21,0,0,0,0,0,0,0,0,0
2021-03-22,0,0,0,0,162,1,0,0,163
2021-03-23,0,0,0,0,195,1,0,1,197
2021-03-24,0,0,0,0,193,0,0,0,193
2021-03-25,0,0,0,0,183,1,0,1,185
2021-03-26,0,0,0,0,211,0,0,0,211
2021-03-27,0,0,0,0,0,0,0,0,0
2021-03-28,0,0,0,0,0,0,0,0,0
2021-03-29,0,0,0,0,1255,4,0,0,1259
2021-03-30,0,0,0,0,1358,4,0,1,1363
2021-03-31,0,0,0,0,1302,5,0,1,1308
2021-04-01,0,0,0,0,1264,9,0,1,1274
2021-04-02,0,0,0,0,1019,2,0,3,1024
2021-04-03,0,0,0,0,532,0,0,0,532
2021-04-04,0,0,0,0,501,0,0,0,501
2021-04-05,0,0,0,0,1582,2,2,3,1589
2021-04-06,0,0,0,0,1626,4,3,3,1636
2021-04-07,0,0,0,0,1663,2,5,1,1671
2021-04-08,0,0,0,0,1516,6,4,2,1528
2021-04-09,0,0,0,0,1142,0,2,2,1146
2021-04-10,0,0,0,0,612,0,3,0,615
2021-04-11,0,0,0,0,527,0,0,0,527
2021-04-12,0,0,0,0,1686,4,2,3,1695
2021-04-13,0,0,0,0,1692,5,2,3,1702
2021-04-14,0,0,0,0,1607,3,4,3,1617
2021-04-15,0,0,0,0,1443,2,2,1,1448
2021-04-16,0,0,0,0,1092,2,2,4,1100
2021-04-17,0,0,0,0,485,1,2,0,488
2021-04-18,0,0,0,0,465,3,3,0,471
2021-04-19,0,0,0,0,1587,4,5,3,1599
2021-04-20,0,0,0,0,1607,2,4,3,1616
2021-04-21,0,0,0,0,1466,2,1,1,1470
2021-04-22,0,0,0,0,1319,6,4,1,1330
2021-04-23,0,0,0,0,959,1,3,2,965
2021-04-24,0,0,0,0,587,0,1,0,588
2021-04-25,0,0,0,0,520,0,3,0,523
2021-04-26,0,0,0,0,1378,5,3,3,1389
2021-04-27,0,0,0,0,1390,3,6,3,1402
2021-04-28,0,0,0,0,1249,3,3,3,1258
2021-04-29,0,0,0,0,1192,4,5,2,1203
2021-04-30,0,0,0,0,252,1,0,1,254
2021-05-01,0,0,0,0,214,0,1,0,215
2021-05-02,0,0,0,0,224,0,1,0,225
2021-05-03,0,0,0,0,567,2,1,2,572
2021-05-04,0,0,0,0,631,1,1,3,636
2021-05-05,0,0,0,0,598,1,1,1,601
2021-05-06,0,0,0,0,524,3,2,2,531
2021-05-07,0,0,0,0,612,1,3,3,619
2021-05-08,0,0,0,0,473,0,1,0,474
2021-05-09,0,0,0,0,410,0,1,0,411
2021-05-10,0,0,0,0,1208,3,3,4,1218
2021-05-11,0,0,0,0,1284,3,4,3,1294
2021-05-12,1,0,0,0,1200,4,4,3,1212
2021-05-13,0,0,0,0,1058,2,3,3,1066
2021-05-14,0,0,0,0,847,1,2,3,853
2021-05-15,0,0,0,0,416,0,2,0,418
2021-05-16,0,0,0,0,435,0,2,0,437
2021-05-17,0,0,0,0,1268,1,7,4,1280
2021-05-18,0,0,0,0,1326,2,4,2,1334
2021-05-19,0,0,0,0,1238,1,4,2,1245
2021-05-20,0,0,0,0,1128,2,4,2,1136
2021-05-21,0,0,0,0,800,2,2,2,806
2021-05-22,0,0,0,0,473,1,1,0,475
2021-05-23,0,0,0,0,420,0,1,0,421
2021-05-24,0,0,0,0,1251,2,2,3,1258
2021-05-25,0,0,0,0,1324,3,3,3,1333
2021-05-26,0,0,0,0,1291,2,4,4,1301
2021-05-27,0,0,0,0,1115,5,4,2,1126
2021-05-28,0,0,0,0,872,2,4,3,881
2021-05-29,0,0,0,0,407,0,2,0,409
2021-05-30,0,0,0,0,363,1,2,3,369
2021-05-31,0,0,0,0,598,0,5,1,604
2021-06-01,0,0,0,0,1102,4,6,2,1114
2021-06-02,0,0,0,0,1133,2,2,2,1139
2021-06-03,0,0,0,0,1048,4,4,2,1058
2021-06-04,0,0,0,0,775,1,2,4,782
2021-06-05,0,0,0,0,454,0,3,1,458
2021-06-06,0,0,0,0,365,1,2,2,370
2021-06-07,0,0,0,0,836,5,3,4,848
2021-06-08,0,0,0,0,766,1,2,3,772
2021-06-09,0,0,0,0,635,1,3,4,643
2021-06-10,0,0,0,0,386,1,3,3,393
2021-06-11,0,0,0,0,337,0,2,0,339
2021-06-12,0,0,0,0,0,0,0,0,0
2021-06-13,0,0,0,0,0,0,0,0,0
2021-06-14,1,15,9,3,111,12,37,1,189
2021-06-15,0,16,8,4,103,11,59,3,204
2021-06-16,0,11,10,5,116,12,77,1,232
2021-06-17,0,14,7,5,100,16,56,1,199
2021-06-18,0,0,0,0,0,0,0,0,0
2021-06-19,0,0,0,0,0,0,0,0,0
2021-06-20,0,0,0,0,0,0,0,0,0
2021-06-21,0,18,13,3,140,15,99,5,293
2021-06-22,0,21,12,5,158,17,103,5,321
2021-06-23,0,22,13,4,139,13,105,2,298
2021-06-24,0,16,8,7,128,13,97,5,274
2021-06-25,0,18,9,3,126,12,82,2,252
2021-06-26,0,2,15,6,44,1,28,1,97
2021-06-27,0,5,6,2,32,2,32,2,81
2021-06-28,0,18,17,5,146,7,124,7,324
2021-06-29,0,23,15,8,141,12,131,7,337
2021-06-30,0,20,14,4,134,15,122,2,311
2021-07-01,0,16,10,8,115,14,106,5,274
2021-07-02,0,19,14,9,98,10,94,4,248
2021-07-03,0,7,7,7,43,2,55,2,123
2021-07-04,0,0,0,0,0,0,0,0,0
2021-07-05,0,0,0,0,0,0,0,0,0
2021-07-06,3,24,17,11,150,15,159,7,386
2021-07-07,0,18,13,6,160,12,136,3,348
2021-07-08,1,20,11,10,152,13,134,5,346
2021-07-09,0,19,16,4,119,11,117,6,292
2021-07-10,1,7,12,5,59,5,61,1,151
2021-07-11,1,4,9,6,53,4,50,1,128
2021-07-12,1,26,14,11,180,20,148,8,408
2021-07-13,1,25,18,12,170,15,143,9,393
2021-07-14,2,16,15,12,178,8,146,7,384
2021-07-15,1,21,16,8,152,12,123,4,337
2021-07-16,2,19,17,6,149,12,122,5,332
2021-07-17,0,6,9,11,81,6,59,4,176
2021-07-18,0,6,10,8,63,3,58,5,153
2021-07-19,2,29,20,13,187,21,148,12,432
2021-07-20,3,30,21,14,192,14,137,8,419
2021-07-21,1,32,15,12,186,12,153,7,418
2021-07-22,2,23,12,14,158,12,124,7,352
2021-07-23,7,20,13,11,131,9,124,6,321
2021-07-24,3,10,12,10,59,5,55,3,157
2021-07-25,3,6,13,6,64,2,53,3,150
2021-07-26,3,33,24,18,191,7,143,7,426
2021-07-27,4,19,23,11,200,13,140,4,414
2021-07-28,2,23,19,16,190,9,142,7,408
2021-07-29,3,28,17,8,175,12,122,8,373
2021-07-30,2,22,14,17,123,5,107,5,295
2021-07-31,4,10,11,5,66,4,57,2,159
2021-08-01,0,9,13,9,50,2,56,3,142
2021-08-02,5,28,22,13,159,8,150,9,394
2021-08-03,5,25,15,14,159,4,152,5,379
2021-08-04,6,23,22,13,154,7,142,7,374
2021-08-05,6,21,16,12,144,10,112,7,328
2021-08-06,4,17,29,10,128,6,114,7,315
2021-08-07,1,7,12,8,66,1,49,3,147
2021-08-08,2,7,11,7,65,7,56,4,159
2021-08-09,1,22,25,18,161,8,149,9,393
2021-08-10,4,16,23,12,159,11,137,10,372
2021-08-11,5,23,21,18,155,11,145,7,385
2021-08-12,4,23,23,12,147,8,117,6,340
2021-08-13,2,19,23,18,134,4,99,5,304
2021-08-14,4,9,14,10,75,2,35,1,150
2021-08-15,7,9,12,8,58,4,44,4,146
2021-08-16,6,24,28,11,158,5,136,9,377
2021-08-17,8,18,20,17,161,6,139,9,378
2021-08-18,8,22,19,14,162,6,126,4,361
2021-08-19,6,20,20,17,149,9,109,8,338
2021-08-20,6,16,17,8,130,4,91,4,276
2021-08-21,2,5,12,9,73,2,51,2,156
2021-08-22,7,6,14,4,58,2,51,4,146
2021-08-23,6,21,27,17,185,8,134,6,404
2021-08-24,5,23,20,14,183,7,128,7,387
2021-08-25,6,19,26,15,178,10,117,7,378
2021-08-26,7,19,21,16,171,8,110,6,358
2021-08-27,8,23,17,11,146,9,110,7,331
2021-08-28,0,0,0,0,0,0,0,0,0
2021-08-29,0,0,0,0,0,0,0,0,0
2021-08-30,0,0,0,0,0,0,0,0,0
2021-08-31,0,0,0,0,0,4,0,0,4
2021-09-01,0,0,0,0,0,0,0,0,0
2021-09-02,0,0,0,0,0,0,0,0,0
2021-09-03,0,0,0,0,0,0,0,0,0
2021-09-04,0,0,0,0,0,0,0,0,0
2021-09-05,0,0,0,0,0,0,0,0,0
2021-09-06,0,0,0,0,0,0,0,0,0
2021-09-07,0,0,0,0,0,0,0,0,0
2021-09-08,0,0,0,0,0,0,0,0,0
2021-09-09,0,0,0,0,1,2,0,0,3
2021-09-10,0,0,0,0,0,5,0,0,5
2021-09-11,0,0,0,0,0,0,0,0,0
2021-09-12,0,0,0,0,0,0,0,0,0
2021-09-13,3,23,14,14,209,6,97,7,373
2021-09-14,0,22,18,13,395,12,89,1,550
2021-09-15,1,28,13,11,478,9,89,5,634
2021-09-16,4,23,11,9,478,12,97,4,638
2021-09-17,2,29,10,11,492,10,73,6,633
2021-09-18,0,0,0,0,0,0,0,0,0
2021-09-19,0,0,0,0,0,0,0,0,0
2021-09-20,4,37,14,7,1117,13,1,10,1203
2021-09-21,5,43,8,11,1261,18,4,7,1357
2021-09-22,1,36,11,14,1298,10,2,9,1381
2021-09-23,5,25,5,8,1351,12,2,9,1417
2021-09-24,1,35,11,13,2222,16,1,9,2308
2021-09-25,1,14,8,5,1204,1,0,3,1236
2021-09-26,3,14,9,9,1600,9,3,6,1653
2021-09-27,2,54,17,18,4188,18,5,17,4319
2021-09-28,5,52,22,21,3768,27,6,10,3911
2021-09-29,1,53,23,22,3595,18,6,13,3731
2021-09-30,4,49,31,21,3226,16,4,15,3366
2021-10-01,5,49,28,19,2346,0,1,10,2458
2021-10-02,2,15,22,6,1261,0,2,6,1314
2021-10-03,5,14,14,8,1426,0,2,6,1475
2021-10-04,5,54,37,25,3789,2,8,15,3935
2021-10-05,8,63,31,20,3377,3,5,12,3519
2021-10-06,4,61,33,32,3256,5,11,20,3422
2021-10-07,3,48,29,20,2753,1,11,18,2883
2021-10-08,5,47,24,25,1963,0,3,10,2077
2021-10-09,1,21,21,7,1265,2,6,9,1332
2021-10-10,7,26,12,12,1119,1,7,4,1188
2021-10-11,6,64,45,25,3244,2,9,17,3412
2021-10-12,5,54,40,28,2999,4,10,12,3152
2021-10-13,11,62,42,31,2792,1,5,18,2962
2021-10-14,8,49,44,24,2699,4,8,18,2854
2021-10-15,4,53,28,16,1485,2,3,12,1603
2021-10-16,1,14,29,12,1161,0,3,8,1228
2021-10-17,8,20,21,9,1025,1,6,5,1095
2021-10-18,5,69,45,23,3289,3,7,18,3459
2021-10-19,5,60,36,32,3126,4,8,15,3286
2021-10-20,8,68,40,27,3004,5,7,19,3178
2021-10-21,6,56,37,21,2631,1,6,13,2771
2021-10-22,6,54,25,21,1899,3,6,11,2025
2021-10-23,4,15,22,7,1189,0,6,12,1255
2021-10-24,15,21,16,14,1078,1,1,12,1158
2021-10-25,12,65,42,22,3187,3,6,19,3356
2021-10-26,5,53,33,23,3062,4,10,15,3205
2021-10-27,13,55,36,21,2938,2,8,21,3094
2021-10-28,8,43,29,19,2499,3,8,12,2621
2021-10-29,9,63,37,23,1527,4,8,10,1681
2021-10-30,2,13,10,11,371,0,1,6,414
2021-10-31,5,22,21,10,830,1,0,5,894
2021-11-01,17,59,37,26,2691,2,5,17,2854
2021-11-02,4,70,39,24,2998,5,8,16,3164
2021-11-03,5,65,35,21,2997,3,10,15,3151
2021-11-04,8,56,43,16,2691,2,6,18,2840
2021-11-05,10,57,32,21,1754,1,4,12,1891
2021-11-06,5,17,24,11,1010,0,3,11,1081
2021-11-07,7,21,22,6,1059,1,4,9,1129
2021-11-08,7,87,44,29,3118,2,14,14,3315
2021-11-09,5,70,39,19,3068,2,14,19,3236
2021-11-10,7,76,42,33,3147,3,16,17,3341
2021-11-11,0,0,0,0,0,0,0,0,0
2021-11-12,10,55,41,27,1944,4,6,15,2102
2021-11-13,7,27,16,7,1027,0,7,9,1100
2021-11-14,10,22,22,9,1126,1,4,7,1201
2021-11-15,10,84,41,31,3205,1,9,17,3398
2021-11-16,5,64,39,27,3034,2,7,17,3195
2021-11-17,6,70,37,23,2796,1,11,19,2963
2021-11-18,8,63,33,19,2603,2,8,15,2751
2021-11-19,8,54,31,20,1777,1,8,10,1909
2021-11-20,5,21,24,7,1059,0,6,4,1126
2021-11-21,2,29,20,12,1056,1,3,9,1132
2021-11-22,17,69,39,27,2682,2,9,11,2856
2021-11-23,7,66,35,13,1924,2,5,16,2068
2021-11-24,9,53,19,16,1081,0,6,13,1197
2021-11-25,0,0,0,0,0,0,0,0,0
2021-11-26,0,0,0,0,0,0,0,0,0
2021-11-27,0,0,0,0,0,0,0,0,0
2021-11-28,0,0,0,0,0,0,0,0,0
2021-11-29,10,67,42,28,2926,2,4,17,3096
2021-11-30,10,64,32,24,2938,2,9,17,3096
2021-12-01,10,66,34,22,2876,0,7,18,3033
2021-12-02,6,52,34,15,2546,1,6,17,2677
2021-12-03,9,64,27,19,1608,1,4,15,1747
2021-12-04,4,17,24,9,1311,0,4,14,1383
2021-12-05,8,24,13,11,1008,1,3,7,1075
2021-12-06,11,58,34,26,1601,0,9,14,1753
2021-12-07,2,54,36,21,1724,2,4,16,1859
2021-12-08,5,68,29,21,1313,0,3,16,1455
2021-12-09,6,44,18,16,1049,4,4,16,1157
2021-12-10,17,59,22,18,694,0,5,16,831
2021-12-11,0,0,0,0,0,0,0,0,0
2021-12-12,0,0,0,0,0,0,0,0,0
2021-12-13,10,49,14,10,409,2,2,8,504
2021-12-14,12,36,19,12,337,1,0,9,426
2021-12-15,10,43,11,5,252,2,2,9,334
2021-12-16,3,36,14,6,214,0,0,7,280
2021-12-17,8,40,16,13,194,2,2,10,285
2021-12-18,0,0,0,0,0,0,0,0,0
2021-12-19,0,0,0,0,0,0,0,0,0
2021-12-20,0,0,0,0,0,0,0,0,0
2021-12-21,0,0,0,0,0,0,0,0,0
2021-12-22,0,0,0,0,0,0,0,0,0
2021-12-23,0,0,0,0,0,0,0,0,0
2021-12-24,0,0,0,0,0,0,0,0,0
2021-12-25,0,0,0,0,0,0,0,0,0
2021-12-26,0,0,0,0,0,0,0,0,0
2021-12-27,0,0,0,0,0,0,0,0,0
2021-12-28,0,0,0,0,0,0,0,0,0
2021-12-29,0,0,0,0,0,0,0,0,0
2021-12-30,0,0,0,0,0,0,0,0,0
2021-12-31,0,0,0,0,0,0,0,0,0
2022-01-01,0,0,0,0,0,0,0,0,0
2022-01-02,0,0,0,0,0,0,0,0,0
2022-01-03,7,49,22,26,3347,5,1,15,3472
2022-01-04,14,45,27,29,3640,2,2,17,3776
2022-01-05,10,51,31,23,3610,4,6,24,3759
2022-01-06,13,46,26,24,3279,0,6,12,3406
2022-01-07,10,46,30,30,2384,1,7,16,2524
2022-01-08,2,19,19,13,1601,1,2,4,1661
2022-01-09,6,21,17,8,1293,0,4,13,1362
2022-01-10,4,60,30,29,3881,2,10,24,4040
2022-01-11,9,61,45,22,3817,5,4,13,3976
2022-01-12,4,63,39,25,3787,2,12,21,3953
2022-01-13,11,59,38,14,3399,4,9,20,3554
2022-01-14,11,46,27,22,2139,3,7,18,2273
2022-01-15,2,22,22,11,1415,3,3,11,1489
2022-01-16,8,26,20,14,1358,1,5,14,1446
2022-01-17,0,0,0,0,0,0,0,0,0
2022-01-18,7,55,39,28,4196,3,12,22,4362
2022-01-19,12,68,36,31,4052,6,16,13,4234
2022-01-20,11,65,37,30,3647,4,9,27,3830
2022-01-21,11,52,30,22,2334,0,5,13,2467
2022-01-22,5,19,27,13,1545,2,8,14,1633
2022-01-23,8,22,23,10,1904,0,7,5,1979
2022-01-24,8,71,38,40,3776,4,9,22,3968
2022-01-25,7,68,41,36,3921,1,14,24,4112
2022-01-26,10,57,38,32,3996,2,18,27,4180
2022-01-27,7,66,36,32,3572,4,12,24,3753
2022-01-28,15,53,33,28,2283,1,11,11,2435
2022-01-29,7,15,24,13,1336,1,3,10,1409
2022-01-30,4,27,17,15,1754,2,6,12,1837
2022-01-31,13,75,41,41,3985,3,12,28,4198
2022-02-01,7,67,39,26,4098,3,15,17,4272
2022-02-02,15,67,39,35,4142,3,15,26,4342
2022-02-03,7,66,37,30,3562,2,12,27,3743
2022-02-04,10,50,33,29,2195,2,5,25,2349
2022-02-05,4,25,21,17,1441,1,2,8,1519
2022-02-06,6,25,15,17,1711,1,7,12,1794
2022-02-07,8,76,42,37,3905,3,10,28,4109
2022-02-08,7,73,33,32,4103,4,14,24,4290
2022-02-09,9,65,39,30,4074,2,16,22,4257
2022-02-10,7,67,31,28,3335,3,10,22,3503
2022-02-11,10,51,31,31,2195,1,7,19,2345
2022-02-12,4,28,21,16,1431,0,6,9,1515
2022-02-13,5,19,15,9,915,2,6,9,980
2022-02-14,9,67,34,35,3389,2,8,20,3564
2022-02-15,7,69,35,42,3713,2,12,23,3903
2022-02-16,6,74,47,34,4090,2,10,22,4285
2022-02-17,10,67,39,30,3467,3,11,22,3649
2022-02-18,7,70,31,32,2283,1,7,19,2450
2022-02-19,8,23,33,19,1359,0,6,10,1458
2022-02-20,9,24,19,20,1561,0,6,14,1653
2022-02-21,6,65,33,39,3779,4,8,22,3956
2022-02-22,7,69,27,35,3907,3,8,19,4075
2022-02-23,9,67,38,33,3937,3,10,27,4124
2022-02-24,6,67,31,31,3161,2,13,17,3328
2022-02-25,13,59,38,22,2196,5,3,19,2355
2022-02-26,10,27,18,22,1328,1,4,8,1418
2022-02-27,5,27,23,19,1750,0,3,9,1836
2022-02-28,12,86,50,41,3830,3,10,18,4050
2022-03-01,12,73,44,40,3982,5,13,14,4183
2022-03-02,10,67,44,26,3866,2,11,20,4046
2022-03-03,13,54,38,32,3521,4,11,22,3695
2022-03-04,8,59,35,29,2173,5,5,16,2330
2022-03-05,7,25,22,22,1441,1,9,5,1532
2022-03-06,9,17,17,18,1646,1,5,6,1719
2022-03-07,7,73,49,43,3875,3,11,22,4083
2022-03-08,11,66,43,29,3511,5,9,18,3692
2022-03-09,11,75,34,36,3455,3,9,19,3642
2022-03-10,9,62,34,20,3052,3,8,19,3207
2022-03-11,8,64,34,22,1893,3,5,18,2047
2022-03-12,8,20,24,15,1433,0,5,5,1510
2022-03-13,9,27,18,19,1428,1,5,7,1514
2022-03-14,6,58,34,35,2061,2,5,13,2214
2022-03-15,8,60,36,32,2006,1,9,14,2166
2022-03-16,7,59,25,27,1673,2,10,13,1816
2022-03-17,11,56,24,19,1118,0,3,15,1246
2022-03-18,8,64,16,21,761,2,5,11,888
2022-03-19,0,0,0,0,0,0,0,0,0
2022-03-20,0,0,0,0,0,0,0,0,0
2022-03-21,12,40,20,22,501,1,1,7,604
2022-03-22,7,43,13,13,357,0,2,8,443
2022-03-23,8,46,21,18,379,1,1,9,483
2022-03-24,0,0,0,0,0,0,0,0,0
2022-03-25,0,0,0,0,0,0,0,0,0
2022-03-26,0,0,0,0,0,0,0,0,0
2022-03-27,0,0,0,0,0,0,0,0,0
2022-03-28,10,81,29,34,4195,4,26,19,4398
2022-03-29,9,73,30,27,4272,3,34,12,4460
2022-03-30,7,73,28,28,4410,2,33,19,4600
2022-03-31,8,66,36,25,3899,2,33,13,4082
2022-04-01,14,61,24,24,2392,2,33,15,2565
2022-04-02,6,16,23,19,1463,0,25,6,1558
2022-04-03,12,29,28,17,1665,1,22,6,1780
2022-04-04,15,74,32,35,4202,4,51,23,4436
2022-04-05,14,77,38,32,4238,3,45,22,4469
2022-04-06,10,77,31,35,4173,4,43,18,4391
2022-04-07,5,70,30,22,3110,1,37,20,3295
2022-04-08,16,68,21,23,2165,2,32,23,2350
2022-04-09,8,23,19,18,1549,1,26,8,1652
2022-04-10,12,19,20,17,1404,0,19,13,1504
2022-04-11,10,84,35,37,4122,6,46,25,4365
2022-04-12,17,81,28,32,3781,3,42,22,4006
2022-04-13,15,85,37,38,3712,4,39,26,3956
2022-04-14,13,70,35,23,3139,3,38,19,3340
2022-04-15,11,55,23,22,1846,2,22,22,2003
2022-04-16,10,22,20,17,1177,0,29,14,1289
2022-04-17,8,20,17,15,1082,0,16,8,1166
2022-04-18,10,88,30,37,3565,4,41,22,3797
2022-04-19,11,77,32,25,3654,1,50,17,3867
2022-04-20,14,75,29,32,3362,4,41,22,3579
2022-04-21,10,69,39,26,3195,2,50,22,3413
2022-04-22,15,65,29,18,2118,3,37,17,2302
2022-04-23,3,20,17,8,799,0,22,10,879
2022-04-24,6,15,22,6,1308,1,19,8,1385
2022-04-25,12,87,41,31,3765,3,50,22,4011
2022-04-26,14,76,42,26,3757,2,51,20,3988
2022-04-27,16,73,33,29,3808,2,43,20,4024
2022-04-28,15,65,28,28,3370,2,34,17,3559
2022-04-29,16,67,28,25,2099,2,33,14,2284
2022-04-30,12,30,24,21,1458,2,37,12,1596
2022-05-01,10,22,20,13,1234,0,21,9,1329
2022-05-02,12,90,38,35,3826,5,40,22,4068
2022-05-03,9,69,52,30,3796,2,42,24,4024
2022-05-04,14,73,37,33,3321,4,41,19,3542
2022-05-05,10,70,30,25,3002,3,37,20,3197
2022-05-06,14,61,44,20,2030,1,24,21,2215
2022-05-07,10,28,26,16,1236,1,19,9,1345
2022-05-08,9,29,26,13,1253,0,14,13,1357
2022-05-09,10,90,57,40,3856,5,37,19,4114
2022-05-10,9,82,48,33,3949,1,50,23,4195
2022-05-11,14,79,52,32,3895,3,31,20,4126
2022-05-12,11,66,42,24,3226,3,38,24,3434
2022-05-13,15,57,39,19,2168,2,25,22,2347
2022-05-14,8,25,35,13,1406,0,18,14,1519
2022-05-15,5,21,26,13,1260,1,18,15,1359
2022-05-16,14,85,39,39,3871,3,36,23,4110
2022-05-17,12,66,43,30,3524,2,45,19,3741
2022-05-18,18,76,41,33,3596,2,35,27,3828
2022-05-19,11,64,43,27,3091,2,39,14,3291
2022-05-20,20,65,32,22,1946,3,18,23,2129
2022-05-21,11,25,18,9,1083,1,18,12,1177
2022-05-22,6,27,22,16,1165,0,16,9,1261
2022-05-23,15,76,42,29,3515,3,31,29,3740
2022-05-24,4,67,43,25,3384,1,35,17,3576
2022-05-25,15,77,26,30,3056,2,36,26,3268
2022-05-26,9,53,37,23,2925,2,27,18,3094
2022-05-27,12,61,27,21,1903,3,24,21,2072
2022-05-28,14,19,19,14,1278,0,15,7,1366
2022-05-29,10,25,18,11,1228,1,19,12,1324
2022-05-30,0,0,0,0,0,0,0,0,0
2022-05-31,14,53,31,16,2362,2,20,14,2512
2022-06-01,12,68,36,36,3118,3,34,24,3331
2022-06-02,16,74,33,22,2571,4,23,19,2762
2022-06-03,20,60,34,26,1812,4,21,13,1990
2022-06-04,15,17,27,15,1178,2,24,9,1287
2022-06-05,13,28,23,15,1068,0,12,6,1165
2022-06-06,16,71,27,33,1901,4,30,18,2100
2022-06-07,12,65,35,25,1692,3,22,30,1884
2022-06-08,15,59,26,33,1342,4,22,18,1519
2022-06-09,12,58,25,20,1113,4,14,14,1260
2022-06-10,17,56,21,18,821,3,17,17,970
2022-06-11,0,0,0,0,0,0,0,0,0
2022-06-12,0,0,0,0,0,0,0,0,0
2022-06-13,16,33,6,6,321,1,18,7,408
2022-06-14,19,40,7,12,238,2,60,6,384
2022-06-15,23,32,11,15,169,2,109,9,370
2022-06-16,16,30,14,13,164,1,128,7,373
2022-06-17,23,40,13,15,143,2,123,9,368
2022-06-18,0,0,0,0,0,0,0,0,0
2022-06-19,0,0,0,0,0,0,0,0,0
2022-06-20,0,0,0,0,0,0,0,0,0
2022-06-21,32,55,21,17,288,9,191,12,625
2022-06-22,30,50,17,18,230,6,188,13,552
2022-06-23,22,41,20,13,233,4,189,10,532
2022-06-24,31,42,12,11,219,4,163,13,495
2022-06-25,9,8,9,2,76,1,67,3,175
2022-06-26,6,8,7,2,81,1,67,3,175
2022-06-27,33,50,17,19,286,8,207,13,633
2022-06-28,18,47,21,16,249,9,234,11,605
2022-06-29,26,51,18,17,285,3,210,16,626
2022-06-30,11,41,17,15,224,5,178,10,501
2022-07-01,27,43,17,16,213,5,155,9,485
2022-07-02,8,4,8,6,105,0,93,4,228
2022-07-03,3,9,4,8,89,2,88,7,210
2022-07-04,0,0,0,0,0,0,0,0,0
2022-07-05,24,42,21,24,201,5,189,10,516
2022-07-06,21,42,18,16,262,5,212,12,588
2022-07-07,19,36,14,17,250,2,196,6,540
2022-07-08,25,24,17,13,213,9,184,10,495
2022-07-09,7,8,4,6,120,1,88,3,237
2022-07-10,7,8,6,9,95,2,79,4,210
2022-07-11,27,49,19,18,266,7,211,7,604
2022-07-12,0,3,0,0,1,1,7,0,12
2022-07-13,0,2,0,0,20,1,7,1,31
2022-07-14,0,0,0,0,2,0,7,0,9
2022-07-15,0,0,0,0,0,0,0,0,0
2022-07-16,0,0,0,0,0,0,0,0,0
2022-07-17,0,0,0,0,0,0,0,0,0
2022-07-18,0,0,0,0,0,0,0,0,0
2022-07-19,0,2,0,0,1,0,7,1,11
2022-07-20,0,1,0,0,0,0,4,0,5
2022-07-21,0,1,0,0,2,1,6,0,10
2022-07-22,0,1,0,0,2,0,4,0,7
2022-07-23,0,0,0,0,0,0,0,0,0
2022-07-24,0,0,0,0,1,0,0,0,1
2022-07-25,12,49,17,21,214,5,204,10,532
2022-07-26,15,43,20,21,229,5,188,9,530
2022-07-27,14,49,24,19,239,3,183,10,541
2022-07-28,11,45,16,13,212,4,203,7,511
2022-07-29,17,51,21,14,209,3,167,12,494
2022-07-30,4,6,5,8,105,1,90,4,223
2022-07-31,6,11,6,9,92,1,73,3,201
2022-08-01,26,50,22,22,264,5,232,14,635
2022-08-02,13,55,17,13,258,2,215,11,584
2022-08-03,20,54,23,16,252,2,217,13,597
2022-08-04,13,46,19,12,196,1,197,5,489
2022-08-05,22,44,15,23,190,2,155,11,462
2022-08-06,5,7,8,7,90,0,77,3,197
2022-08-07,2,11,6,7,90,1,78,7,202
2022-08-08,14,66,22,22,258,3,222,8,615
2022-08-09,13,56,20,16,222,6,200,10,543
2022-08-10,17,46,19,17,200,1,214,8,522
2022-08-11,13,50,15,18,191,3,188,8,486
2022-08-12,25,29,19,16,178,2,168,6,443
2022-08-13,5,7,5,5,75,0,72,3,172
2022-08-14,6,9,12,3,96,3,94,2,225
2022-08-15,15,64,19,20,215,6,202,12,553
2022-08-16,12,66,13,13,258,5,198,5,570
2022-08-17,16,42,18,19,237,2,187,7,528
2022-08-18,11,50,16,13,224,3,178,9,504
2022-08-19,20,38,19,16,202,1,173,9,478
2022-08-20,4,4,8,7,91,1,71,1,187
2022-08-21,3,15,8,4,79,1,74,7,191
2022-08-22,16,55,29,16,285,4,210,13,628
2022-08-23,18,38,22,11,246,3,195,7,540
2022-08-24,19,39,22,15,236,1,174,11,517
2022-08-25,19,38,17,13,212,4,170,10,483
2022-08-26,21,45,20,14,190,4,167,10,471
2022-08-27,0,0,0,0,0,0,0,0,0
2022-08-28,0,0,0,0,0,0,0,0,0
2022-08-29,0,0,0,0,0,0,0,0,0
2022-08-30,0,0,0,0,0,0,0,0,0
2022-08-31,0,0,0,0,0,0,0,0,0
2022-09-01,0,0,0,0,0,0,0,0,0
2022-09-02,0,0,0,0,0,1,0,0,1
2022-09-03,0,0,0,0,0,0,0,0,0
2022-09-04,0,0,0,0,0,0,0,0,0
2022-09-05,0,0,0,0,0,0,0,0,0
2022-09-06,0,0,0,0,0,0,0,0,0
2022-09-07,0,0,0,0,0,0,0,0,0
2022-09-08,0,0,0,0,0,0,0,0,0
2022-09-09,0,0,0,0,0,0,0,0,0
2022-09-10,0,0,0,0,0,0,0,0,0
2022-09-11,0,0,0,0,0,0,0,0,0
2022-09-12,14,49,15,16,719,2,41,15,871
2022-09-13,12,34,12,12,717,2,25,10,824
2022-09-14,8,55,16,19,705,2,34,6,845
2022-09-15,8,33,17,10,655,1,22,9,755
2022-09-16,10,37,18,20,784,2,20,12,903
2022-09-17,0,0,0,0,0,0,0,0,0
2022-09-18,0,0,0,0,0,0,0,0,0
2022-09-19,17,52,23,23,1468,6,3,11,1603
2022-09-20,11,45,16,14,1535,6,7,8,1642
2022-09-21,18,48,19,22,1582,5,5,12,1711
2022-09-22,4,50,15,14,1819,4,7,13,1926
2022-09-23,14,40,23,18,2064,1,7,8,2175
2022-09-24,3,11,17,10,1553,0,4,4,1602
2022-09-25,8,24,15,12,1876,1,6,8,1950
2022-09-26,23,84,24,25,3950,4,9,12,4131
2022-09-27,15,90,38,20,5301,2,17,15,5498
2022-09-28,18,71,27,25,4841,5,8,15,5010
2022-09-29,12,81,20,20,4239,4,8,11,4395
2022-09-30,11,64,26,19,3004,6,6,17,3153
2022-10-01,12,23,19,13,1580,0,8,6,1661
2022-10-02,7,25,17,14,1682,0,5,6,1756
2022-10-03,13,76,29,37,4700,1,10,24,4890
2022-10-04,8,90,30,23,4549,2,8,15,4725
2022-10-05,16,80,40,26,4111,3,10,25,4311
2022-10-06,10,89,38,27,3710,4,7,19,3904
2022-10-07,12,60,35,27,2571,0,6,20,2731
2022-10-08,4,20,24,14,1473,0,3,9,1547
2022-10-09,14,27,22,19,1420,3,6,9,1520
2022-10-10,13,87,37,28,4185,3,8,24,4385
2022-10-11,13,89,36,31,3950,4,11,19,4153
2022-10-12,20,75,38,23,3834,4,9,27,4030
2022-10-13,10,84,34,23,3574,2,9,21,3757
2022-10-14,15,58,26,26,2399,1,6,16,2547
2022-10-15,6,29,21,15,1477,0,3,10,1561
2022-10-16,8,24,19,19,1321,0,6,8,1405
2022-10-17,19,88,34,37,4047,0,11,24,4260
2022-10-18,14,100,35,28,4013,1,8,15,4214
2022-10-19,10,73,39,36,3961,2,13,27,4161
2022-10-20,14,92,44,21,3649,3,13,19,3855
2022-10-21,22,58,29,28,2126,2,5,12,2282
2022-10-22,5,24,17,8,605,0,4,11,674
2022-10-23,7,29,16,18,1456,1,4,13,1544
2022-10-24,16,84,37,30,4008,1,6,19,4201
2022-10-25,11,94,43,25,3965,3,12,16,4169
2022-10-26,18,76,39,26,3679,5,14,23,3880
2022-10-27,13,81,32,21,3104,2,9,19,3281
2022-10-28,23,57,41,27,2017,6,4,13,2188
2022-10-29,7,24,25,14,1261,0,5,8,1344
2022-10-30,6,31,17,21,1232,0,6,7,1320
2022-10-31,17,75,39,33,3311,1,8,12,3496
2022-11-01,12,86,40,28,3688,3,13,20,3890
2022-11-02,19,75,42,29,3790,1,11,24,3991
2022-11-03,11,79,32,27,3393,3,12,22,3579
2022-11-04,18,66,27,27,2309,3,7,16,2473
2022-11-05,10,25,24,15,1414,3,5,11,1507
2022-11-06,19,33,20,17,1554,0,7,15,1665
2022-11-07,15,89,39,37,4003,4,9,19,4215
2022-11-08,11,98,38,33,4145,2,8,24,4359
2022-11-09,14,78,36,27,3921,3,10,24,4113
2022-11-10,7,96,38,30,3511,3,9,28,3722
2022-11-11,0,0,0,0,0,0,0,0,0
2022-11-12,13,37,24,29,1007,1,1,14,1126
2022-11-13,5,28,27,23,1522,0,5,9,1619
2022-11-14,12,81,38,30,3913,2,7,17,4100
2022-11-15,11,101,44,22,3850,2,9,18,4057
2022-11-16,12,83,35,34,3759,3,11,14,3951
2022-11-17,5,79,38,27,3186,2,8,18,3363
2022-11-18,24,62,36,26,2151,2,6,19,2326
2022-11-19,6,40,22,14,1128,3,4,7,1224
2022-11-20,16,41,24,14,1223,0,3,8,1329
2022-11-21,21,88,32,27,2962,2,6,18,3156
2022-11-22,22,96,40,23,2448,4,6,16,2655
2022-11-23,18,71,16,27,1212,3,3,9,1359
2022-11-24,0,0,0,0,0,0,0,0,0
2022-11-25,0,0,0,0,0,0,0,0,0
2022-11-26,0,0,0,0,0,0,0,0,0
2022-11-27,0,0,0,0,0,0,0,0,0
2022-11-28,21,101,35,33,3410,1,6,22,3629
2022-11-29,12,91,39,32,3552,3,6,17,3752
2022-11-30,22,67,36,30,3460,4,8,17,3644
2022-12-01,10,73,38,18,2918,2,7,17,3083
2022-12-02,24,64,30,27,2101,3,4,16,2269
2022-12-03,11,35,20,20,1569,1,4,7,1667
2022-12-04,15,34,21,11,1456,0,3,5,1545
2022-12-05,22,77,32,26,2218,2,6,10,2393
2022-12-06,13,86,33,19,2055,2,6,15,2229
2022-12-07,15,65,33,21,1826,3,10,9,1982
2022-12-08,15,62,33,25,1429,3,6,14,1587
2022-12-09,18,59,25,25,910,2,6,11,1056
2022-12-10,0,0,0,0,0,0,0,0,0
2022-12-11,0,0,0,0,0,0,0,0,0
2022-12-12,0,0,0,0,0,0,0,0,0
2022-12-13,0,0,0,0,0,0,0,0,0
2022-12-14,0,0,0,0,0,0,0,0,0
2022-12-15,0,0,0,0,0,0,0,0,0
2022-12-16,0,0,0,0,0,0,0,0,0
2022-12-17,0,0,0,0,0,0,0,0,0
2022-12-18,0,0,0,0,0,0,0,0,0
2022-12-19,0,0,0,0,0,0,0,0,0
2022-12-20,0,0,0,0,0,0,0,0,0
2022-12-21,0,0,0,0,0,0,0,0,0
2022-12-22,0,0,0,0,0,0,0,0,0
2022-12-23,0,0,0,0,0,0,0,0,0
2022-12-24,0,0,0,0,0,0,0,0,0
2022-12-25,0,0,0,0,0,0,0,0,0
2022-12-26,0,0,0,0,0,0,0,0,0
2022-12-27,0,0,0,0,0,0,0,0,0
2022-12-28,0,0,0,0,0,0,0,0,0
2022-12-29,0,0,0,0,0,0,0,0,0
2022-12-30,0,0,0,0,0,0,0,0,0
2022-12-31,0,0,0,0,0,0,0,0,0
2023-01-01,0,0,0,0,0,0,0,0,0
2023-01-02,0,0,0,0,0,0,0,0,0
2023-01-03,7,49,19,17,270,3,0,9,374
2023-01-04,7,54,13,25,402,1,0,7,509
2023-01-05,12,59,19,21,504,1,1,7,624
2023-01-06,9,57,17,23,646,2,0,12,766
2023-01-07,0,0,0,0,0,0,0,0,0
2023-01-08,0,0,0,0,0,0,0,0,0
2023-01-09,11,108,34,39,5264,3,2,22,5483
2023-01-10,14,97,46,36,5510,2,4,17,5726
2023-01-11,12,99,43,44,5125,2,4,20,5349
2023-01-12,8,100,43,22,4538,1,6,16,4734
2023-01-13,21,83,29,30,3215,2,8,15,3403
2023-01-14,10,42,25,24,1902,3,3,12,2021
2023-01-15,11,45,19,18,2027,0,4,10,2134
2023-01-16,0,0,0,0,0,0,0,0,0
2023-01-17,13,118,48,35,5570,3,5,27,5819
2023-01-18,7,93,47,47,5277,2,13,19,5505
2023-01-19,14,122,56,32,4749,4,20,22,5019
2023-01-20,18,74,38,22,3019,2,17,11,3201
2023-01-21,6,47,25,20,2006,2,8,9,2123
2023-01-22,18,43,18,12,1796,2,9,12,1910
2023-01-23,11,123,44,46,5084,3,25,22,5358
2023-01-24,12,103,47,43,5190,3,26,27,5451
2023-01-25,22,85,44,47,4755,5,26,28,5012
2023-01-26,9,113,47,35,4426,2,25,25,4682
2023-01-27,13,67,34,32,2978,3,20,19,3166
2023-01-28,18,38,36,24,1874,0,16,8,2014
2023-01-29,18,37,22,12,2009,0,10,11,2119
2023-01-30,15,98,41,34,4818,2,25,24,5057
2023-01-31,19,108,33,37,4955,2,20,25,5199
2023-02-01,14,78,40,34,4834,0,18,18,5036
2023-02-02,14,98,40,37,4395,3,19,22,4628
2023-02-03,16,68,30,33,3013,5,19,13,3197
2023-02-04,17,45,21,20,2024,2,14,9,2152
2023-02-05,18,38,23,22,2216,1,12,8,2338
2023-02-06,17,102,39,37,4986,4,31,31,5247
2023-02-07,20,104,48,37,4986,3,31,24,5253
2023-02-08,20,112,42,39,4840,3,19,25,5100
2023-02-09,11,93,42,24,4040,3,26,25,4264
2023-02-10,16,82,36,33,2665,5,16,18,2871
2023-02-11,8,28,21,22,1889,4,11,11,1994
2023-02-12,10,25,16,17,1231,0,7,10,1316
2023-02-13,19,91,39,44,4485,3,24,29,4734
2023-02-14,12,76,37,28,4265,1,22,24,4465
2023-02-15,21,93,45,50,4717,6,25,32,4989
2023-02-16,10,102,42,35,4331,4,32,26,4582
2023-02-17,8,75,38,37,2603,5,21,13,2800
2023-02-18,11,42,28,25,1644,2,12,22,1786
2023-02-19,12,33,24,23,1858,2,15,8,1975
2023-02-20,20,79,47,45,4381,4,27,19,4622
2023-02-21,12,107,43,37,4859,6,32,30,5126
2023-02-22,21,83,53,49,4682,3,22,28,4941
2023-02-23,12,86,39,36,4175,5,28,22,4403
2023-02-24,17,61,34,36,2855,7,16,14,3040
2023-02-25,12,34,29,24,1575,0,12,14,1700
2023-02-26,11,44,22,27,2045,1,15,9,2174
2023-02-27,16,80,38,49,4599,3,32,24,4841
2023-02-28,26,90,34,38,4812,3,30,26,5059
2023-03-01,15,97,43,47,4628,4,25,24,4883
2023-03-02,15,93,36,27,4290,3,26,21,4511
2023-03-03,10,72,32,40,2863,2,14,13,3046
2023-03-04,14,36,23,30,1732,0,14,21,1870
2023-03-05,16,39,20,29,2018,2,8,14,2146
2023-03-06,13,100,34,48,4792,4,26,31,5048
2023-03-07,15,95,40,40,4713,4,32,25,4964
2023-03-08,16,75,43,54,4519,4,22,21,4754
2023-03-09,14,87,28,31,4359,5,24,18,4566
2023-03-10,19,69,36,33,2818,4,16,17,3012
2023-03-11,8,32,24,28,1557,2,13,9,1673
2023-03-12,16,43,19,26,1880,2,13,9,2008
2023-03-13,20,79,39,40,4220,3,31,30,4462
2023-03-14,13,94,52,34,4227,4,22,24,4470
2023-03-15,15,84,47,40,4130,5,21,19,4361
2023-03-16,13,78,31,37,3712,2,21,19,3913
2023-03-17,17,62,40,30,2069,6,15,12,2251
2023-03-18,9,32,23,19,1373,1,13,8,1478
2023-03-19,21,32,26,20,1425,1,9,9,1543
2023-03-20,16,88,43,39,2408,4,20,21,2639
2023-03-21,12,80,45,31,2142,1,14,16,2341
2023-03-22,13,70,48,39,1745,2,16,15,1948
2023-03-23,25,70,32,36,1346,2,15,15,1541
2023-03-24,13,76,24,31,880,3,10,13,1050
2023-03-25,0,0,0,0,0,0,0,0,0
2023-03-26,0,0,0,0,0,0,0,0,0
2023-03-27,10,56,15,15,471,2,8,10,587
2023-03-28,9,45,10,18,434,0,8,5,529
2023-03-29,11,49,13,15,390,2,8,7,495
2023-03-30,10,33,8,17,387,0,11,2,468
2023-03-31,17,52,16,21,473,2,9,4,594
2023-04-01,0,0,0,0,0,0,0,0,0
2023-04-02,0,0,0,0,0,0,0,0,0
2023-04-03,21,90,28,39,4824,6,14,21,5043
2023-04-04,21,86,37,34,5243,6,34,19,5480
2023-04-05,21,79,48,47,4867,6,35,22,5125
2023-04-06,16,79,43,31,4581,1,37,16,4804
2023-04-07,17,68,34,35,3170,0,31,16,3371
2023-04-08,17,47,26,27,1748,3,12,13,1893
2023-04-09,13,37,19,26,1627,2,15,6,1745
2023-04-10,17,97,43,39,4957,5,42,27,5227
2023-04-11,7,96,47,46,5212,2,55,33,5498
2023-04-12,23,86,46,47,4854,5,55,24,5140
2023-04-13,13,82,48,31,4343,3,46,20,4586
2023-04-14,20,56,27,35,2630,3,39,12,2822
2023-04-15,10,32,28,29,1486,1,18,14,1618
2023-04-16,17,41,26,29,1660,0,20,13,1806
2023-04-17,22,101,41,52,4538,4,51,26,4835
2023-04-18,17,91,49,45,4801,3,62,29,5097
2023-04-19,27,93,52,50,4424,4,54,30,4734
2023-04-20,19,99,42,30,3684,3,43,16,3936
2023-04-21,20,62,33,42,2866,3,42,24,3092
2023-04-22,10,29,34,22,1556,2,24,13,1690
2023-04-23,17,38,30,25,1633,2,23,14,1782
2023-04-24,20,112,44,47,4538,8,58,35,4862
2023-04-25,15,101,45,37,4568,4,47,21,4838
2023-04-26,19,78,36,45,4008,3,55,22,4266
2023-04-27,14,90,38,38,3586,3,44,19,3832
2023-04-28,11,67,28,29,1941,3,26,21,2126
2023-04-29,8,32,10,23,793,1,9,9,885
2023-04-30,13,20,21,26,1516,0,18,7,1621
2023-05-01,9,87,44,39,4419,4,53,25,4680
2023-05-02,16,101,42,41,4708,3,57,26,4994
2023-05-03,18,98,38,38,4348,2,53,22,4617
2023-05-04,15,95,46,48,4020,6,40,20,4290
2023-05-05,20,67,37,34,2741,5,31,17,2952
2023-05-06,13,38,25,26,1651,1,21,13,1788
2023-05-07,13,31,21,32,1500,1,16,19,1633
2023-05-08,17,100,46,51,4135,7,46,24,4426
2023-05-09,16,101,50,39,4687,5,55,21,4974
2023-05-10,11,100,55,51,4013,7,45,26,4308
2023-05-11,19,93,40,29,3722,3,39,22,3967
2023-05-12,16,75,31,36,2111,3,34,14,2320
2023-05-13,12,37,26,20,1050,1,9,15,1170
2023-05-14,13,29,15,16,1004,1,13,11,1102
2023-05-15,17,107,38,39,4132,3,44,28,4408
2023-05-16,23,95,41,44,4399,6,48,25,4681
2023-05-17,24,88,47,47,3951,8,57,23,4245
2023-05-18,19,76,30,29,3709,3,43,12,3921
2023-05-19,16,67,31,32,2220,3,32,12,2413
2023-05-20,13,17,18,21,1408,1,16,6,1500
2023-05-21,18,24,16,24,1415,1,19,12,1529
2023-05-22,16,77,36,40,4171,3,49,26,4418
2023-05-23,17,91,49,33,4291,4,47,19,4551
2023-05-24,20,92,33,38,3913,3,53,24,4176
2023-05-25,19,74,32,25,3257,4,31,17,3459
2023-05-26,17,70,29,30,1957,2,23,12,2140
2023-05-27,6,33,24,13,1175,0,13,10,1274
2023-05-28,12,30,25,17,1290,2,14,11,1401
2023-05-29,0,0,0,0,0,0,0,0,0
2023-05-30,21,79,41,35,4061,3,57,22,4319
2023-05-31,27,84,38,39,3895,3,54,22,4162
2023-06-01,15,76,39,25,3383,4,37,18,3597
2023-06-02,17,70,30,32,2299,1,35,18,2502
2023-06-03,14,37,19,12,1350,2,20,13,1467
2023-06-04,9,27,16,21,1358,1,14,10,1456
2023-06-05,23,88,38,39,3680,3,46,20,3937
2023-06-06,20,76,36,32,3608,4,42,19,3837
2023-06-07,28,82,44,43,3658,7,48,22,3932
2023-06-08,12,49,27,16,2268,4,26,12,2414
2023-06-09,28,68,33,24,2091,1,22,14,2281
2023-06-10,13,29,19,16,1151,3,15,6,1252
2023-06-11,14,28,21,17,1118,0,15,6,1219
2023-06-12,22,79,36,34,1892,3,34,18,2118
2023-06-13,31,74,41,27,1893,3,30,17,2116
2023-06-14,23,66,29,25,1456,1,36,18,1654
2023-06-15,24,58,37,22,1081,3,20,13,1258
2023-06-16,24,59,26,28,873,2,21,13,1046
2023-06-17,0,0,0,0,0,0,0,0,0
2023-06-18,0,0,0,0,0,0,0,0,0
2023-06-19,0,0,0,0,0,0,0,0,0
2023-06-20,17,46,18,9,107,3,71,8,279
2023-06-21,21,52,17,15,140,9,85,4,343
2023-06-22,15,49,22,19,124,9,104,7,349
2023-06-23,20,40,17,11,129,5,105,6,333
2023-06-24,0,0,0,0,0,0,0,0,0
2023-06-25,0,0,0,0,0,0,0,0,0
2023-06-26,28,83,25,33,319,15,154,12,669
2023-06-27,23,67,23,25,277,17,175,15,622
2023-06-28,29,73,25,28,273,19,160,16,623
2023-06-29,16,66,21,31,238,12,151,9,544
2023-06-30,17,54,27,20,190,9,152,10,479
2023-07-01,13,14,5,15,64,6,58,4,179
2023-07-02,0,0,0,0,0,0,0,0,0
2023-07-03,24,74,21,26,258,15,176,14,608
2023-07-04,0,0,0,0,0,0,0,0,0
2023-07-05,14,79,27,33,233,14,180,20,600
2023-07-06,19,63,26,26,240,14,200,13,601
2023-07-07,18,55,15,21,213,12,176,11,521
2023-07-08,4,18,8,14,110,8,95,4,261
2023-07-09,0,0,0,0,0,0,0,0,0
2023-07-10,17,71,24,29,296,23,232,18,710
2023-07-11,10,62,32,25,298,21,220,18,686
2023-07-12,19,70,19,30,297,18,209,13,675
2023-07-13,13,63,15,19,256,14,191,11,582
2023-07-14,21,53,15,22,217,13,145,12,498
2023-07-15,6,17,12,14,100,5,64,8,226
2023-07-16,0,0,0,0,0,0,0,0,0
2023-07-17,26,88,26,35,299,17,241,21,753
2023-07-18,24,73,29,29,269,15,206,16,661
2023-07-19,24,82,23,31,267,20,203,16,666
2023-07-20,38,71,23,19,242,16,164,13,586
2023-07-21,18,58,20,17,187,8,134,16,458
2023-07-22,10,22,12,12,102,8,81,8,255
2023-07-23,0,0,0,0,0,0,0,0,0
2023-07-24,30,78,32,36,291,25,223,18,733
2023-07-25,22,59,49,17,264,16,178,21,626
2023-07-26,26,71,31,29,276,15,188,9,645
2023-07-27,26,55,24,19,228,15,163,13,543
2023-07-28,23,50,15,17,175,12,149,18,459
2023-07-29,6,17,16,20,106,6,75,9,255
2023-07-30,0,0,0,0,0,0,0,0,0
2023-07-31,18,84,27,26,300,24,212,23,714
2023-08-01,14,68,36,33,288,14,192,20,665
2023-08-02,20,72,29,28,263,21,195,20,648
2023-08-03,13,61,22,19,244,15,167,15,556
2023-08-04,15,55,20,25,176,12,139,14,456
2023-08-05,7,16,9,21,85,3,85,10,236
2023-08-06,0,0,0,0,0,0,0,0,0
2023-08-07,22,77,28,34,308,11,221,26,727
2023-08-08,16,73,26,25,266,13,198,14,631
2023-08-09,21,67,27,28,280,10,176,15,624
2023-08-10,17,54,18,15,236,7,148,12,507
2023-08-11,23,61,16,24,174,3,135,9,445
2023-08-12,6,23,6,17,96,5,71,8,232
2023-08-13,0,0,0,0,0,0,0,0,0
2023-08-14,28,62,25,39,263,9,223,16,665
2023-08-15,8,16,6,5,96,3,48,5,187
2023-08-16,26,58,31,36,266,18,194,21,650
2023-08-17,26,62,26,24,212,4,191,14,559
2023-08-18,25,49,20,20,168,10,152,11,455
2023-08-19,5,15,11,18,86,2,90,8,235
2023-08-20,0,0,0,0,0,0,0,0,0
2023-08-21,24,72,23,34,320,12,219,18,722
2023-08-22,22,56,23,25,296,8,193,13,636
2023-08-23,22,72,18,23,273,17,196,15,636
2023-08-24,33,52,25,20,236,3,185,11,565
2023-08-25,23,51,16,24,199,9,141,18,481
2023-08-26,0,0,0,0,0,0,0,0,0
2023-08-27,0,0,0,0,0,0,0,0,0
2023-08-28,0,0,0,0,0,0,0,0,0
2023-08-29,0,0,0,0,0,0,0,0,0
2023-08-30,0,0,0,0,0,0,0,0,0
2023-08-31,0,0,0,0,0,0,0,0,0
2023-09-01,0,0,0,0,0,0,0,0,0
2023-09-02,0,0,0,0,0,0,0,0,0
2023-09-03,0,0,0,0,0,0,0,0,0
2023-09-04,0,0,0,0,0,0,0,0,0
2023-09-05,0,0,0,0,0,0,0,0,0
2023-09-06,0,0,0,0,0,0,0,0,0
2023-09-07,0,0,0,0,0,0,0,0,0
2023-09-08,0,0,0,0,0,0,0,0,0
2023-09-09,0,0,0,0,0,0,0,0,0
2023-09-10,0,0,0,0,0,0,0,0,0
2023-09-11,17,69,20,24,516,11,161,19,837
2023-09-12,17,55,19,22,533,11,146,13,816
2023-09-13,10,70,21,25,600,17,160,11,914
2023-09-14,12,56,19,21,591,14,124,22,859
2023-09-15,10,77,17,26,594,14,129,11,878
2023-09-16,0,0,0,0,0,0,0,0,0
2023-09-17,0,0,0,0,0,0,0,0,0
2023-09-18,14,66,16,22,1346,14,2,17,1497
2023-09-19,16,61,25,24,1482,7,3,11,1629
2023-09-20,14,53,15,27,1531,6,3,15,1664
2023-09-21,14,39,19,20,1722,6,4,10,1834
2023-09-22,10,54,25,32,2225,5,2,9,2362
2023-09-23,0,0,0,0,0,0,0,0,0
2023-09-24,5,19,17,14,2250,1,1,9,2316
2023-09-25,22,78,28,42,4448,5,5,19,4647
2023-09-26,13,99,33,38,5868,7,9,20,6087
2023-09-27,20,82,31,42,4938,6,6,24,5149
2023-09-28,17,77,29,36,4499,6,3,22,4689
2023-09-29,11,72,31,36,3191,4,5,20,3370
2023-09-30,5,28,16,19,2007,0,5,11,2091
2023-10-01,13,33,15,19,2003,0,5,12,2100
2023-10-02,14,93,44,48,4923,3,9,23,5157
2023-10-03,23,91,37,47,5167,2,11,28,5406
2023-10-04,16,88,34,44,4533,3,10,27,4755
2023-10-05,18,78,35,39,4010,2,12,17,4211
2023-10-06,13,75,26,34,3001,2,8,16,3175
2023-10-07,6,18,18,15,1779,0,4,8,1848
2023-10-08,12,32,16,20,1638,0,6,11,1735
2023-10-09,10,100,40,52,4343,3,10,25,4583
2023-10-10,24,99,39,40,4302,2,10,23,4539
2023-10-11,14,107,38,46,3821,2,10,25,4063
2023-10-12,11,84,32,39,3643,1,9,26,3845
2023-10-13,14,73,28,37,2251,2,12,19,2436
2023-10-14,4,23,14,16,1341,0,5,10,1413
2023-10-15,10,33,20,19,1655,0,5,12,1754
2023-10-16,17,112,35,47,4419,1,10,27,4668
2023-10-17,18,99,40,53,4664,1,13,37,4925
2023-10-18,16,105,36,41,4156,3,8,26,4391
2023-10-19,12,79,34,39,3663,3,5,29,3864
2023-10-20,9,65,31,36,2390,3,11,21,2566
2023-10-21,4,23,17,17,831,1,3,7,903
2023-10-22,14,37,21,17,1734,0,7,12,1842
2023-10-23,14,119,44,50,4424,3,10,24,4688
2023-10-24,17,104,45,45,4403,2,14,38,4668
2023-10-25,10,103,31,41,3811,4,7,25,4032
2023-10-26,9,79,37,38,3520,1,5,21,3710
2023-10-27,18,72,31,33,2199,1,7,15,2376
2023-10-28,10,31,23,12,1243,0,3,15,1337
2023-10-29,13,30,18,19,1318,1,5,14,1418
2023-10-30,18,114,38,46,3703,3,10,26,3958
2023-10-31,15,91,43,42,3872,2,11,26,4102
2023-11-01,19,96,45,41,3876,3,11,30,4121
2023-11-02,17,99,41,44,4023,2,14,26,4266
2023-11-03,11,75,42,42,2703,2,7,24,2906
2023-11-04,15,31,20,22,1026,2,8,15,1139
2023-11-05,11,41,27,20,1938,2,6,23,2068
2023-11-06,18,110,43,52,4305,3,13,33,4577
2023-11-07,19,87,54,41,4693,3,11,35,4943
2023-11-08,18,99,39,42,4160,3,7,30,4398
2023-11-09,23,76,43,42,3724,3,5,27,3943
2023-11-10,13,58,41,29,2133,2,5,17,2298
2023-11-11,0,0,0,0,0,0,0,0,0
2023-11-12,17,35,27,23,1736,2,3,10,1853
2023-11-13,16,105,37,50,4067,6,9,31,4321
2023-11-14,21,88,39,40,4214,3,12,34,4451
2023-11-15,17,99,42,49,3968,2,6,26,4209
2023-11-16,25,81,39,34,3633,4,10,30,3856
2023-11-17,11,77,33,43,2546,0,6,18,2734
2023-11-18,7,31,20,21,1462,2,5,13,1561
2023-11-19,10,35,25,21,1707,4,3,8,1813
2023-11-20,14,98,44,49,3375,1,7,30,3618
2023-11-21,23,90,37,40,2530,3,6,23,2752
2023-11-22,24,83,29,28,1468,2,5,18,1657
2023-11-23,0,0,0,0,0,0,0,0,0
2023-11-24,0,0,0,0,0,0,0,0,0
2023-11-25,0,0,0,0,0,0,0,0,0
2023-11-26,0,0,0,0,0,0,0,0,0
2023-11-27,22,116,46,48,3942,3,11,30,4218
2023-11-28,25,98,42,41,4162,5,11,27,4411
2023-11-29,14,102,37,39,3939,4,10,23,4168
2023-11-30,21,88,42,31,3389,2,8,20,3601
2023-12-01,25,73,37,31,1993,4,6,21,2190
2023-12-02,17,43,20,23,1689,1,7,10,1810
2023-12-03,19,35,34,22,1641,2,4,11,1768
2023-12-04,21,98,37,44,2565,4,5,23,2797
2023-12-05,22,89,33,33,2395,2,7,23,2604
2023-12-06,17,95,30,46,1949,2,2,22,2163
2023-12-07,20,87,31,37,1521,3,5,19,1723
2023-12-08,19,85,28,36,868,3,3,17,1059
2023-12-09,0,0,0,0,0,0,0,0,0
2023-12-10,0,0,0,0,0,0,0,0,0
2023-12-11,0,0,0,0,0,0,0,0,0
2023-12-12,0,0,0,0,0,0,0,0,0
2023-12-13,0,0,0,0,0,0,0,0,0
2023-12-14,0,0,0,0,0,0,0,0,0
2023-12-15,0,0,0,0,0,0,0,0,0
2023-12-16,0,0,0,0,0,0,0,0,0
2023-12-17,0,0,0,0,0,0,0,0,0
2023-12-18,0,0,0,0,0,0,0,0,0
2023-12-19,0,0,0,0,0,0,0,0,0
2023-12-20,0,0,0,0,0,0,0,0,0
2023-12-21,0,0,0,0,0,0,0,0,0
2023-12-22,0,0,0,0,0,0,0,0,0
2023-12-23,0,0,0,0,0,0,0,0,0
2023-12-24,0,0,0,0,0,0,0,0,0
2023-12-25,0,0,0,0,0,0,0,0,0
2023-12-26,0,0,0,0,0,0,0,0,0
2023-12-27,0,0,0,0,0,0,0,0,0
2023-12-28,0,0,0,0,0,0,0,0,0
2023-12-29,0,0,0,0,0,0,0,0,0
2023-12-30,0,0,0,0,0,0,0,0,0
2023-12-31,0,0,0,0,0,0,0,0,0
2024-01-01,0,0,0,0,0,0,0,0,0
2024-01-02,13,33,12,17,226,1,1,7,310
2024-01-03,12,36,13,18,316,1,1,15,412
2024-01-04,17,43,11,18,377,2,4,15,487
2024-01-05,14,54,12,23,500,2,1,18,624
2024-01-06,0,0,0,0,0,0,0,0,0
2024-01-07,0,0,0,0,0,0,0,0,0
2024-01-08,14,110,36,42,5574,2,8,29,5815
2024-01-09,24,102,48,39,5774,4,12,25,6028
2024-01-10,15,97,49,31,5329,3,12,29,5565
2024-01-11,20,100,43,31,4829,3,10,26,5062
2024-01-12,14,78,42,25,3212,4,9,27,3411
2024-01-13,10,18,18,9,1537,1,4,10,1607
2024-01-14,0,0,0,0,0,0,0,0,0
2024-01-15,0,0,0,0,0,0,0,0,0
2024-01-16,1,4,14,8,1826,1,7,5,1866
2024-01-17,3,12,19,9,2104,1,11,0,2159
2024-01-18,27,85,38,31,5108,3,14,32,5338
2024-01-19,13,78,42,46,3665,8,13,21,3886
2024-01-20,16,40,29,24,2176,2,10,14,2311
2024-01-21,13,38,20,19,2227,3,8,15,2343
2024-01-22,19,119,49,51,5867,3,24,31,6163
2024-01-23,23,137,61,42,5647,6,19,30,5965
2024-01-24,12,114,47,41,5341,4,20,28,5607
2024-01-25,11,110,47,46,4810,3,16,34,5077
2024-01-26,14,94,38,35,3141,8,16,21,3367
2024-01-27,19,41,24,26,1901,1,10,15,2037
2024-01-28,7,36,24,17,2077,1,7,13,2182
2024-01-29,21,134,55,46,5355,5,20,38,5674
2024-01-30,15,109,57,31,5482,5,14,25,5738
2024-01-31,17,117,48,42,5339,6,20,31,5620
2024-02-01,12,96,51,31,4798,7,17,30,5042
2024-02-02,13,91,32,38,3070,5,13,23,3285
2024-02-03,12,29,25,18,1890,1,5,17,1997
2024-02-04,10,46,20,21,2176,1,9,17,2300
2024-02-05,22,120,50,43,5143,5,19,34,5436
2024-02-06,16,120,50,39,5296,8,24,25,5578
2024-02-07,20,105,46,47,5162,4,24,36,5444
2024-02-08,21,97,46,33,4397,5,18,32,4649
2024-02-09,19,84,33,39,2880,10,13,18,3096
2024-02-10,8,38,25,13,1978,2,6,12,2082
2024-02-11,12,40,16,22,1162,1,3,13,1269
2024-02-12,22,119,36,48,4790,4,22,44,5085
2024-02-13,17,110,46,33,5085,5,20,33,5349
2024-02-14,13,121,43,31,4345,5,16,24,4598
2024-02-15,20,87,46,44,4237,6,15,26,4481
2024-02-16,11,96,42,33,2787,3,8,17,2997
2024-02-17,16,42,21,28,1826,1,5,14,1953
2024-02-18,14,44,20,21,1994,1,5,9,2108
2024-02-19,15,135,45,42,4764,4,15,33,5053
2024-02-20,19,117,46,40,5337,3,14,29,5605
2024-02-21,17,106,38,47,5259,6,19,28,5520
2024-02-22,17,95,50,34,4574,6,13,26,4815
2024-02-23,9,71,33,31,2726,4,7,16,2897
2024-02-24,12,32,18,25,1619,1,1,11,1719
2024-02-25,12,39,24,20,2195,0,2,9,2301
2024-02-26,13,125,42,45,5149,4,17,33,5428
2024-02-27,17,113,40,46,5361,1,16,25,5619
2024-02-28,14,102,46,35,4841,5,14,26,5083
2024-02-29,19,88,34,37,4570,4,13,27,4792
2024-03-01,12,79,24,25,2942,3,9,22,3116
2024-03-02,13,35,21,29,1970,2,9,16,2095
2024-03-03,6,36,22,22,2159,3,5,13,2266
2024-03-04,14,102,47,39,4963,2,18,37,5222
2024-03-05,15,111,43,40,4886,4,14,26,5139
2024-03-06,14,97,45,37,4707,6,15,23,4944
2024-03-07,15,98,44,34,4252,4,11,19,4477
2024-03-08,12,72,27,28,2793,6,9,18,2965
2024-03-09,10,40,25,15,1825,12,3,10,1940
2024-03-10,17,40,23,19,1727,4,5,9,1844
2024-03-11,19,107,47,46,4484,5,21,32,4761
2024-03-12,13,95,33,39,4677,4,15,23,4899
2024-03-13,11,82,44,33,4403,5,15,24,4617
2024-03-14,11,81,44,29,3761,1,17,20,3964
2024-03-15,15,58,29,31,2507,5,6,11,2662
2024-03-16,7,23,16,17,1202,3,5,10,1283
2024-03-17,13,27,16,18,1399,3,3,6,1485
2024-03-18,9,87,33,31,2294,2,10,17,2483
2024-03-19,17,93,29,35,2248,1,9,14,2446
2024-03-20,14,80,34,37,1806,1,6,14,1992
2024-03-21,17,75,30,26,1240,2,7,15,1412
2024-03-22,13,66,17,19,749,0,1,16,881
2024-03-23,0,0,0,0,0,0,0,0,0
2024-03-24,0,0,0,0,0,0,0,0,0
2024-03-25,0,0,0,0,1,3,0,0,4
2024-03-26,12,37,12,21,450,1,1,7,541
2024-03-27,7,47,18,22,441,1,1,8,545
2024-03-28,11,42,15,15,435,3,2,12,535
2024-03-29,8,46,11,20,374,1,0,9,469
2024-03-30,0,0,0,0,0,0,0,0,0
2024-03-31,0,0,0,0,0,0,0,0,0
2024-04-01,12,105,31,44,4952,3,6,26,5179
2024-04-02,8,104,36,39,5214,2,25,16,5444
2024-04-03,13,89,39,37,5047,6,22,18,5271
2024-04-04,17,85,32,35,4863,4,26,22,5084
2024-04-05,22,73,35,26,3101,4,13,25,3299
2024-04-06,15,32,19,22,2056,0,9,11,2164
2024-04-07,13,38,17,20,2125,1,19,11,2244
2024-04-08,11,103,32,36,5243,6,37,30,5498
2024-04-09,19,102,47,40,5267,3,28,30,5536
2024-04-10,12,87,43,33,4886,5,35,19,5120
2024-04-11,11,98,37,37,4572,9,36,24,4824
2024-04-12,19,74,33,28,3005,3,22,15,3199
2024-04-13,14,25,18,18,1719,0,19,15,1828
2024-04-14,4,36,13,20,1838,0,14,8,1933
2024-04-15,17,98,39,44,4821,5,39,32,5095
2024-04-16,19,108,41,42,4902,4,30,28,5174
2024-04-17,12,91,41,38,4597,6,45,25,4855
2024-04-18,8,93,34,26,4136,4,29,20,4350
2024-04-19,7,66,26,31,2233,1,18,14,2396
2024-04-20,5,19,19,22,1359,0,9,13,1446
2024-04-21,14,33,18,14,1635,4,17,7,1742
2024-04-22,11,95,36,40,4383,4,26,21,4616
2024-04-23,11,99,40,42,4590,6,38,25,4851
2024-04-24,10,84,39,29,4170,5,27,20,4384
2024-04-25,7,89,28,30,3812,3,35,17,4021
2024-04-26,16,62,30,29,2620,4,23,14,2798
2024-04-27,7,9,1,10,195,0,3,6,231
2024-04-28,10,43,20,20,1662,2,7,10,1774
2024-04-29,16,100,41,39,4326,7,31,22,4582
2024-04-30,25,97,46,41,4501,6,35,22,4773
2024-05-01,11,72,37,34,4239,6,36,15,4450
2024-05-02,17,88,40,37,3868,6,25,23,4104
2024-05-03,11,60,28,25,2419,2,15,10,2570
2024-05-04,15,33,14,25,1722,2,14,14,1839
2024-05-05,11,41,17,13,1746,4,15,11,1858
2024-05-06,19,104,36,41,4318,4,32,26,4580
2024-05-07,14,103,37,33,4643,5,40,20,4895
2024-05-08,13,83,35,39,4049,5,36,27,4287
2024-05-09,9,104,42,29,3533,4,26,25,3772
2024-05-10,14,76,29,38,2000,3,9,18,2187
2024-05-11,9,18,10,15,973,1,11,7,1044
2024-05-12,11,21,20,12,1166,0,8,8,1246
2024-05-13,9,87,42,46,4249,7,23,24,4487
2024-05-14,13,105,44,41,4536,3,28,22,4792
2024-05-15,11,80,40,33,4034,4,34,27,4263
2024-05-16,15,90,36,26,3705,5,27,19,3923
2024-05-17,20,63,33,21,2243,2,17,10,2409
2024-05-18,9,26,16,20,1428,3,10,7,1519
2024-05-19,11,38,18,17,1338,2,13,8,1445
2024-05-20,12,101,38,41,4140,8,36,28,4404
2024-05-21,24,100,31,48,4349,4,45,26,4627
2024-05-22,17,91,33,32,4026,6,38,28,4271
2024-05-23,12,93,35,26,3366,1,28,17,3578
2024-05-24,15,71,30,18,2205,0,17,19,2375
2024-05-25,12,24,14,18,1267,0,11,9,1355
2024-05-26,16,26,18,16,1243,1,7,7,1334
2024-05-27,0,0,0,0,0,0,0,0,0
2024-05-28,25,88,38,40,4191,4,35,24,4445
2024-05-29,10,83,36,37,4207,4,35,25,4437
2024-05-30,15,84,34,30,3733,3,24,16,3939
2024-05-31,14,70,24,28,2220,3,15,19,2393
2024-06-01,7,36,13,18,1320,2,6,13,1415
2024-06-02,14,37,23,21,1500,3,18,9,1625
2024-06-03,20,83,36,37,4139,7,32,22,4376
2024-06-04,17,94,42,33,3986,4,34,19,4229
2024-06-05,10,41,25,20,2403,2,20,6,2527
2024-06-06,25,94,38,31,3286,2,21,19,3516
2024-06-07,15,53,29,24,1887,2,11,16,2037
2024-06-08,16,20,16,16,1195,2,9,12,1286
2024-06-09,12,27,16,8,1148,1,10,17,1239
2024-06-10,12,78,41,27,1941,3,26,13,2141
2024-06-11,18,80,36,28,1965,3,28,18,2176
2024-06-12,18,68,28,33,1451,2,22,14,1636
2024-06-13,16,75,22,24,1143,0,16,17,1313
2024-06-14,16,56,16,28,670,2,10,9,807
2024-06-15,0,0,0,0,0,0,0,0,0
2024-06-16,0,0,0,0,0,0,0,0,0
2024-06-17,14,41,9,20,238,1,5,6,334
2024-06-18,11,43,10,19,280,0,8,7,378
2024-06-19,0,0,0,0,0,0,0,0,0
2024-06-20,25,44,9,17,108,4,94,8,309
2024-06-21,16,41,10,11,113,6,82,9,288
2024-06-22,0,0,0,0,0,0,0,0,0
2024-06-23,0,0,0,0,0,0,0,0,0
2024-06-24,31,68,11,29,248,17,154,13,571
2024-06-25,26,65,13,24,203,20,154,11,516
2024-06-26,21,55,12,12,212,17,149,11,489
2024-06-27,28,54,12,24,152,8,124,9,411
2024-06-28,18,45,11,15,157,10,123,13,392
2024-06-29,7,7,5,7,69,2,39,2,138
2024-06-30,0,0,0,0,0,0,0,0,0
2024-07-01,30,75,15,31,251,11,177,15,605
2024-07-02,23,58,12,20,225,10,163,18,529
2024-07-03,23,55,18,19,234,13,166,16,544
2024-07-04,0,0,0,0,0,0,0,0,0
2024-07-05,29,38,14,21,165,5,127,10,409
2024-07-06,12,14,6,10,82,5,69,6,204
2024-07-07,0,0,0,0,0,0,0,0,0
2024-07-08,43,81,18,34,297,12,201,20,706
2024-07-09,35,72,19,22,265,15,185,15,628
2024-07-10,31,57,17,23,257,14,175,9,583
2024-07-11,30,63,16,23,215,14,167,17,545
2024-07-12,12,56,16,20,191,11,148,15,469
2024-07-13,11,13,7,12,91,3,73,5,215
2024-07-14,0,0,0,0,0,0,0,0,0
2024-07-15,40,70,17,24,298,12,196,14,671
2024-07-16,40,71,18,23,285,16,164,17,634
2024-07-17,27,58,17,25,262,13,174,15,591
2024-07-18,24,50,10,19,211,12,130,10,466
2024-07-19,34,54,8,20,190,7,139,15,467
2024-07-20,8,11,7,11,98,4,73,3,215
2024-07-21,0,0,0,0,0,0,0,0,0
2024-07-22,31,75,15,29,273,17,173,15,628
2024-07-23,17,70,18,21,306,16,165,12,625
2024-07-24,22,68,14,17,240,16,151,8,536
2024-07-25,21,61,12,23,220,8,142,12,499
2024-07-26,14,42,10,17,176,10,135,16,420
2024-07-27,7,13,5,10,92,3,72,4,206
2024-07-28,0,0,0,0,0,0,0,0,0
2024-07-29,41,65,16,25,302,9,178,18,654
2024-07-30,19,76,16,20,289,13,171,14,618
2024-07-31,29,60,15,22,235,9,167,14,551
2024-08-01,30,57,14,21,221,10,136,13,502
2024-08-02,20,40,10,17,189,4,133,11,424
2024-08-03,7,11,6,12,85,1,66,4,192
2024-08-04,0,0,0,0,0,0,0,0,0
2024-08-05,26,69,15,27,288,9,197,11,642
2024-08-06,21,61,16,27,257,11,156,13,562
2024-08-07,16,49,9,17,228,9,150,7,485
2024-08-08,26,72,11,24,244,16,140,11,544
2024-08-09,19,53,10,21,193,3,134,13,446
2024-08-10,9,19,7,7,75,4,58,5,184
2024-08-11,0,0,0,0,0,0,0,0,0
2024-08-12,28,62,15,28,269,9,176,15,602
2024-08-13,18,75,17,29,223,9,177,10,558
2024-08-14,20,77,11,21,201,5,163,11,509
2024-08-15,14,68,10,22,190,14,142,8,468
2024-08-16,20,49,14,18,172,12,128,14,427
2024-08-17,7,12,6,8,66,7,69,2,177
2024-08-18,0,0,0,0,0,0,0,0,0
2024-08-19,17,71,18,33,246,15,203,16,619
2024-08-20,21,72,13,18,237,10,168,9,548
2024-08-21,20,70,14,28,208,6,179,10,535
2024-08-22,18,54,8,26,200,8,139,10,463
2024-08-23,23,39,10,21,158,6,134,8,399
2024-08-24,9,9,3,9,95,3,72,3,203
2024-08-25,0,0,0,0,0,0,0,0,0
2024-08-26,24,72,14,29,249,9,176,14,587
2024-08-27,23,69,11,21,210,5,159,7,505
2024-08-28,20,60,11,23,180,5,152,7,458
2024-08-29,17,63,12,18,172,10,122,10,424
2024-08-30,20,48,9,24,150,5,121,11,388
2024-08-31,0,0,0,0,0,0,0,0,0
2024-09-01,0,0,0,0,0,0,0,0,0
2024-09-02,0,0,0,0,0,0,0,0,0
2024-09-03,0,0,0,0,0,0,0,0,0
2024-09-04,0,0,0,0,0,0,0,0,0
2024-09-05,0,0,0,0,0,0,0,0,0
2024-09-06,0,0,0,0,0,0,0,0,0
2024-09-07,0,0,0,0,0,0,0,0,0
2024-09-08,0,0,0,0,0,0,0,0,0
2024-09-09,0,0,0,0,0,0,0,0,0
2024-09-10,0,0,0,0,0,0,0,0,0
2024-09-11,0,0,0,0,0,0,0,0,0
2024-09-12,0,0,0,0,0,0,0,0,0
2024-09-13,0,0,0,0,0,0,0,0,0
2024-09-14,0,0,0,0,0,0,0,0,0
2024-09-15,0,0,0,0,0,0,0,0,0
2024-09-16,22,64,20,22,227,9,154,7,525
2024-09-17,18,73,19,23,231,10,147,4,525
2024-09-18,10,52,20,18,756,11,143,7,1017
2024-09-19,4,57,19,19,697,10,125,8,939
2024-09-20,12,57,15,19,730,8,96,6,943
2024-09-21,0,0,0,0,0,0,0,0,0
2024-09-22,0,0,0,0,0,0,0,0,0
2024-09-23,14,67,19,29,1705,4,2,9,1849
2024-09-24,12,65,18,26,1640,2,0,10,1773
2024-09-25,13,61,17,32,1780,2,2,12,1919
2024-09-26,10,43,17,18,1927,4,2,6,2027
2024-09-27,12,47,18,21,2440,1,4,9,2552
2024-09-28,2,9,7,8,2041,0,3,1,2071
2024-09-29,12,9,9,7,1594,0,1,6,1638
2024-09-30,18,99,37,34,6086,2,6,20,6302
2024-10-01,15,100,35,27,5790,5,6,22,6000
2024-10-02,20,91,32,30,5220,3,6,18,5420
2024-10-03,18,93,25,23,4429,3,9,17,4617
2024-10-04,10,53,10,17,1731,1,5,9,1836
2024-10-05,11,25,17,17,2145,0,5,10,2230
2024-10-06,8,28,10,15,1956,0,4,8,2029
2024-10-07,16,95,41,30,5330,0,5,22,5539
2024-10-08,16,97,42,34,5258,6,10,20,5483
2024-10-09,12,86,33,26,4273,1,7,15,4453
2024-10-10,18,84,26,29,3858,4,6,20,4045
2024-10-11,13,67,25,17,2786,0,6,15,2929
2024-10-12,6,17,5,9,421,0,3,6,467
2024-10-13,7,30,14,12,1569,0,3,9,1644
2024-10-14,14,98,34,27,4428,2,8,23,4634
2024-10-15,10,105,35,20,4303,2,9,17,4501
2024-10-16,19,93,27,32,4053,3,6,20,4253
2024-10-17,19,96,30,27,3783,3,10,21,3989
2024-10-18,10,67,24,26,2236,2,6,13,2384
2024-10-19,5,24,17,21,1668,1,0,6,1742
2024-10-20,8,22,16,14,1752,0,4,13,1829
2024-10-21,18,104,37,33,4477,6,11,15,4701
2024-10-22,14,91,33,31,4266,5,8,16,4464
2024-10-23,10,85,39,31,3973,5,6,17,4166
2024-10-24,19,86,38,27,3540,4,10,12,3736
2024-10-25,9,70,28,25,2154,1,3,12,2302
2024-10-26,2,18,3,10,262,0,1,1,297
2024-10-27,8,32,19,17,1806,2,2,11,1897
2024-10-28,18,102,37,40,4576,4,9,14,4800
2024-10-29,14,97,37,33,4506,6,9,27,4729
2024-10-30,9,78,32,33,3941,1,8,11,4113
2024-10-31,16,86,24,26,2995,7,6,13,3173
2024-11-01,9,62,18,27,1939,1,3,9,2068
2024-11-02,6,28,12,19,1367,1,2,10,1445
2024-11-03,12,35,18,20,1696,1,1,9,1792
2024-11-04,15,91,36,38,4342,2,6,18,4548
2024-11-05,13,96,35,32,4326,8,8,23,4541
2024-11-06,20,82,37,32,4254,1,8,17,4451
2024-11-07,22,86,39,26,3750,3,9,14,3949
2024-11-08,12,66,28,22,2626,1,7,14,2776
2024-11-09,1,20,8,12,662,0,0,6,709
2024-11-10,16,43,22,20,1914,4,4,15,2038
2024-11-11,0,0,0,0,0,0,0,0,0
2024-11-12,20,101,39,39,4728,2,10,13,4952
2024-11-13,24,94,36,30,4458,0,4,16,4662
2024-11-14,15,84,32,31,4009,5,7,19,4202
2024-11-15,20,81,18,36,2593,1,6,10,2765
2024-11-16,8,29,10,15,1753,1,3,8,1827
2024-11-17,19,37,15,21,1874,1,4,9,1980
2024-11-18,16,94,38,42,4378,2,7,21,4598
2024-11-19,15,101,40,36,4563,2,10,17,4784
2024-11-20,17,76,37,35,4133,1,8,17,4324
2024-11-21,16,102,30,34,3873,6,7,15,4083
2024-11-22,20,76,33,38,2769,2,7,12,2957
2024-11-23,13,31,28,20,1878,1,6,10,1987
2024-11-24,10,32,18,18,1699,1,3,7,1788
2024-11-25,21,88,27,38,3618,2,5,16,3815
2024-11-26,10,95,23,29,2427,1,3,12,2600
2024-11-27,12,65,24,24,1331,1,3,15,1475
2024-11-28,0,0,0,0,0,0,0,0,0
2024-11-29,0,0,0,0,0,0,0,0,0
2024-11-30,0,0,0,0,0,0,0,0,0
2024-12-01,0,0,0,0,0,0,0,0,0
2024-12-02,24,103,26,40,3871,1,4,21,4090
2024-12-03,19,88,27,34,3974,5,6,18,4171
2024-12-04,12,83,27,31,3777,4,4,19,3957
2024-12-05,17,81,32,23,3228,6,6,10,3403
2024-12-06,9,71,27,15,2223,3,3,11,2362
2024-12-07,8,29,15,12,1235,0,5,4,1308
2024-12-08,6,32,11,12,1339,1,1,10,1412
2024-12-09,13,80,25,27,1994,1,1,7,2148
2024-12-10,16,84,30,25,1993,2,5,15,2170
2024-12-11,13,74,29,25,1542,2,4,13,1702
2024-12-12,14,74,17,23,1111,1,4,9,1253
2024-12-13,21,72,16,21,595,1,3,7,736
2024-12-14,0,0,0,0,0,0,0,0,0
2024-12-15,0,0,0,0,0,0,0,0,0
